//MAP CONVERTED BY dmm2tgm.py THIS HEADER COMMENT PREVENTS RECONVERSION, DO NOT REMOVE
"a" = (
/turf/closed/indestructible/riveted,
/area/mafia)
"b" = (
/turf/open/indestructible/reebe_void,
/area/mafia)
"c" = (
/turf/open/indestructible/reebe_void/spawning/lattices,
/area/mafia)
"d" = (
/obj/mafia_game_board,
/turf/open/indestructible/reebe_void/spawning/lattices,
/area/mafia)
"e" = (
/turf/closed/wall/clockwork,
/area/mafia)
"f" = (
/turf/open/floor/clockwork/reebe,
/area/mafia)
"g" = (
/obj/effect/landmark/mafia,
/turf/open/floor/clockwork/reebe,
/area/mafia)
"h" = (
/obj/structure/window/reinforced/clockwork/fulltile,
/obj/structure/grille/ratvar,
/obj/machinery/door/poddoor/preopen{
	desc = "When it's time to sleep, the lights will go out. Remember - no one in space can hear you scream.";
	id = "mafia";
	max_integrity = 99999;
	name = "Station Night Shutters"
	},
/turf/open/floor/clockwork/reebe,
/area/mafia)
"i" = (
/obj/structure/bed,
/obj/item/bedsheet/orange,
/turf/open/floor/clockwork/reebe,
/area/mafia)
"j" = (
/obj/structure/chair/brass{
	dir = 4
	},
/turf/open/floor/clockwork/reebe,
/area/mafia)
"k" = (
/obj/structure/chair/brass,
/turf/open/floor/clockwork/reebe,
/area/mafia)
"l" = (
/obj/structure/chair/brass{
	dir = 8
	},
/turf/open/floor/clockwork/reebe,
/area/mafia)
"m" = (
/obj/effect/baseturf_helper/asteroid,
/obj/effect/landmark/mafia/town_center,
/obj/structure/chair/brass,
/turf/open/floor/clockwork/reebe,
/area/mafia)
"n" = (
/obj/structure/chair/brass{
	dir = 1;
	icon_state = "brass_chair"
	},
/turf/open/floor/clockwork/reebe,
/area/mafia)
"o" = (
/obj/item/toy/plush/plushvar,
/turf/open/floor/clockwork/reebe,
/area/mafia)
"p" = (
/obj/structure/window/reinforced/clockwork/fulltile,
/obj/structure/grille/ratvar,
/turf/open/floor/clockwork/reebe,
/area/mafia)
"q" = (
/obj/item/toy/plush/plushvar,
/turf/open/indestructible/reebe_void/spawning/lattices,
/area/mafia)

(1,1,1) = {"
a
a
a
a
a
a
a
a
a
a
a
a
a
a
a
a
a
a
a
a
a
a
a
"}
(2,1,1) = {"
a
b
b
b
b
b
b
b
b
b
b
b
b
b
b
b
b
b
b
b
b
b
a
"}
(3,1,1) = {"
a
b
b
c
c
c
b
b
b
b
b
b
b
b
b
b
b
c
c
c
b
b
a
"}
(4,1,1) = {"
a
b
b
c
d
c
b
b
b
b
b
b
b
b
b
b
b
q
d
c
b
b
a
"}
(5,1,1) = {"
a
b
b
c
c
c
c
b
e
e
p
e
p
e
e
b
b
c
c
c
b
b
a
"}
(6,1,1) = {"
a
b
b
b
b
p
p
e
e
i
f
e
f
i
e
e
p
p
c
b
b
b
a
"}
(7,1,1) = {"
a
b
b
b
b
p
i
f
h
g
f
h
f
g
h
f
i
p
b
b
b
b
a
"}
(8,1,1) = {"
a
b
b
b
b
e
g
f
e
e
f
e
f
e
e
f
g
e
b
b
b
b
a
"}
(9,1,1) = {"
a
b
b
b
e
e
h
f
j
h
j
h
j
h
j
f
h
e
e
b
b
b
a
"}
(10,1,1) = {"
a
b
b
b
e
i
h
e
h
h
h
h
h
h
h
e
h
i
e
b
b
b
a
"}
(11,1,1) = {"
a
b
b
b
p
g
f
f
k
h
f
f
o
h
n
f
f
g
p
b
b
b
a
"}
(12,1,1) = {"
a
b
b
b
e
e
h
e
h
h
f
m
f
h
h
e
h
e
e
b
b
b
a
"}
(13,1,1) = {"
a
b
b
b
p
g
f
f
k
h
f
f
f
h
n
f
f
g
p
b
b
b
a
"}
(14,1,1) = {"
a
b
b
b
e
i
h
e
h
h
h
h
h
h
h
e
h
i
e
b
b
b
a
"}
(15,1,1) = {"
a
b
b
b
e
e
h
f
l
h
l
h
l
h
l
f
h
e
e
b
b
b
a
"}
(16,1,1) = {"
a
b
b
b
b
e
g
f
e
e
f
e
f
e
e
f
g
e
b
b
b
b
a
"}
(17,1,1) = {"
a
b
b
b
b
p
i
f
h
g
f
h
f
g
h
f
i
p
b
b
b
b
a
"}
(18,1,1) = {"
a
b
b
b
b
p
p
e
e
f
i
e
i
f
e
e
p
p
c
b
b
b
a
"}
(19,1,1) = {"
a
b
b
c
c
c
c
b
e
e
p
e
p
e
e
b
b
c
c
c
b
b
a
"}
(20,1,1) = {"
a
b
b
c
d
c
b
b
b
b
b
b
b
b
b
b
b
c
d
c
b
b
a
"}
(21,1,1) = {"
a
b
b
c
c
c
b
b
b
b
b
b
b
b
b
b
b
c
c
c
b
b
a
"}
(22,1,1) = {"
a
b
b
b
b
b
b
b
b
b
b
b
b
b
b
b
b
b
b
b
b
b
a
"}
(23,1,1) = {"
a
a
a
a
a
a
a
a
a
a
a
a
a
a
a
a
a
a
a
a
a
a
a
"}
