"aa" = (/turf/open/space/basic,/area/space)
"ab" = (/turf/closed/indestructible,/area/library/lounge)
"ac" = (/turf/closed/indestructible,/area/library)
"ad" = (/obj/structure/disposalpipe/segment,/obj/structure/cable/yellow{icon_state = "1-2"},/turf/open/floor/plasteel/dark,/area/library)
"ae" = (/turf/open/indestructible/hotelwood,/area/library/lounge)
"af" = (/obj/structure/disposalpipe/segment,/obj/structure/cable/yellow{icon_state = "1-2"},/obj/machinery/door/airlock/maintenance{name = "Library Maintenance"; req_one_access_txt = "12;37"},/turf/open/floor/plasteel/dark,/area/library)
"ag" = (/obj/structure/table/wood,/obj/item/flashlight/lamp/green{pixel_x = 1; pixel_y = 5},/obj/machinery/newscaster{pixel_y = 32},/turf/open/floor/plasteel/grimy,/area/library)
"ah" = (/obj/effect/turf_decal/bot,/obj/structure/plasticflaps/opaque,/turf/open/floor/plasteel/dark,/area/library)
"ai" = (/obj/structure/table/wood,/obj/item/folder,/obj/item/folder,/obj/machinery/computer/security/telescreen/entertainment{pixel_y = 30},/turf/open/floor/plasteel/grimy,/area/library)
"aj" = (/obj/structure/table/wood,/obj/item/flashlight/lamp/green{pixel_x = 1; pixel_y = 5},/obj/machinery/computer/security/telescreen/entertainment{pixel_y = 30},/turf/open/floor/plasteel/grimy,/area/library)
"ak" = (/obj/structure/table/wood,/obj/machinery/newscaster{pixel_y = 32},/obj/item/folder,/obj/item/folder,/turf/open/floor/plasteel/grimy,/area/library)
"al" = (/obj/machinery/vending/games,/turf/open/indestructible/hotelwood,/area/library/lounge)
"am" = (/obj/structure/chair/comfy/brown{dir = 1},/turf/open/floor/plasteel/grimy,/area/library)
"an" = (/turf/open/floor/plasteel/grimy,/area/library)
"ao" = (/obj/machinery/door/airlock{name = "Unisex Restroom"},/turf/open/indestructible/hoteltile,/area/library/lounge)
"ap" = (/obj/structure/table/wood/fancy/red,/turf/open/indestructible/hotelwood,/area/library/lounge)
"aq" = (/turf/open/floor/plasteel/dark,/area/library)
"ar" = (/obj/effect/turf_decal/delivery,/turf/open/floor/plasteel/dark,/area/library)
"as" = (/turf/open/floor/carpet/green,/area/library/lounge)
"at" = (/turf/open/indestructible/hotelwood,/area/library)
"au" = (/obj/machinery/bookbinder,/turf/open/indestructible/hotelwood,/area/library)
"av" = (/obj/structure/chair/wood,/turf/open/floor/carpet/green,/area/library/lounge)
"aw" = (/obj/machinery/light/small{dir = 1},/turf/open/indestructible/hotelwood,/area/library/lounge)
"ax" = (/obj/effect/landmark/start/librarian,/turf/open/indestructible/hoteltile,/area/library/lounge)
"ay" = (/obj/structure/bookcase/random/religion,/turf/open/indestructible/hotelwood,/area/library)
"az" = (/obj/structure/bookcase/random/nonfiction,/turf/open/indestructible/hotelwood,/area/library)
"aA" = (/turf/open/indestructible,/area/library)
"aB" = (/obj/structure/bookcase/random/fiction,/turf/open/indestructible/hotelwood,/area/library)
"aC" = (/turf/open/floor/carpet/red,/area/library)
"aD" = (/obj/structure/disposalpipe/segment{dir = 4},/obj/structure/cable/yellow{icon_state = "4-8"},/turf/open/floor/plasteel/dark,/area/library)
"aE" = (/obj/structure/bookcase/random/reference,/turf/open/indestructible/hotelwood,/area/library)
"aF" = (/obj/structure/bookcase/manuals/engineering,/turf/open/indestructible/hotelwood,/area/library)
"aG" = (/obj/structure/bookcase/random/adult,/turf/open/indestructible/hotelwood,/area/library)
"aH" = (/obj/structure/bookcase/manuals/medical,/turf/open/indestructible/hotelwood,/area/library)
"aI" = (/turf/template_noop,/area/template_noop)
"aJ" = (/obj/machinery/light/small{dir = 1},/turf/open/indestructible/hoteltile,/area/library/lounge)
"aK" = (/obj/structure/chair/wood{icon_state = "wooden_chair"; dir = 4},/turf/open/floor/carpet/green,/area/library/lounge)
"aL" = (/obj/structure/bookcase/manuals/research_and_development,/turf/open/indestructible/hotelwood,/area/library)
"aM" = (/obj/structure/table/wood/fancy/red,/obj/machinery/atmospherics/components/unary/vent_scrubber/on{dir = 4},/turf/open/floor/carpet/green,/area/library/lounge)
"aN" = (/obj/structure/chair/wood{icon_state = "wooden_chair"; dir = 8},/obj/machinery/atmospherics/pipe/simple/scrubbers/hidden{dir = 4},/turf/open/floor/carpet/green,/area/library/lounge)
"aO" = (/obj/machinery/atmospherics/pipe/simple/scrubbers/hidden{dir = 10},/turf/open/indestructible/hotelwood,/area/library/lounge)
"aP" = (/obj/machinery/vending/wardrobe/curator_wardrobe,/turf/open/floor/plasteel/dark,/area/library)
"aQ" = (/obj/machinery/door/morgue{name = "Study #1"},/turf/open/floor/plasteel/grimy,/area/library)
"aR" = (/obj/machinery/door/morgue{name = "Study #2"},/turf/open/floor/plasteel/grimy,/area/library)
"aS" = (/obj/structure/table/wood/fancy/red,/obj/machinery/atmospherics/components/unary/vent_pump/on{dir = 4},/turf/open/indestructible/hotelwood,/area/library/lounge)
"aT" = (/obj/structure/table/wood/fancy/red,/obj/machinery/atmospherics/pipe/simple/supply/hidden{dir = 10},/turf/open/floor/carpet/green,/area/library/lounge)
"aU" = (/obj/structure/chair/wood{icon_state = "wooden_chair"; dir = 8},/turf/open/floor/carpet/green,/area/library/lounge)
"aV" = (/obj/machinery/atmospherics/pipe/simple/scrubbers/hidden,/turf/open/indestructible/hotelwood,/area/library/lounge)
"aW" = (/obj/machinery/disposal/bin,/obj/structure/disposalpipe/trunk{dir = 4},/turf/open/indestructible/hotelwood,/area/library/lounge)
"aX" = (/obj/structure/table/wood/fancy/red,/obj/machinery/computer/libraryconsole/bookmanagement{pixel_y = 8},/obj/structure/disposalpipe/segment{dir = 4},/obj/structure/window/spawner/west,/turf/open/indestructible/hotelwood,/area/library)
"aY" = (/obj/structure/sink{dir = 8; pixel_x = -12; pixel_y = 2},/obj/structure/mirror{pixel_x = -24},/turf/open/indestructible/hoteltile,/area/library/lounge)
"aZ" = (/obj/machinery/newscaster{pixel_y = 32},/obj/structure/disposalpipe/segment{dir = 4},/turf/open/indestructible/hotelwood,/area/library)
"ba" = (/obj/structure/disposalpipe/junction/flip{dir = 1},/turf/open/indestructible/hotelwood,/area/library)
"bb" = (/obj/machinery/disposal/bin,/obj/structure/disposalpipe/trunk,/obj/structure/window/spawner/east,/turf/open/indestructible/hotelwood,/area/library)
"bc" = (/obj/structure/chair/wood{icon_state = "wooden_chair"; dir = 1},/turf/open/floor/carpet/green,/area/library/lounge)
"bd" = (/obj/structure/chair/wood{icon_state = "wooden_chair"; dir = 1},/obj/machinery/atmospherics/pipe/simple/supply/hidden,/turf/open/floor/carpet/green,/area/library/lounge)
"be" = (/obj/machinery/door/window/westright,/turf/open/indestructible/hotelwood,/area/library)
"bf" = (/obj/structure/disposalpipe/segment{dir = 5},/turf/open/indestructible/hotelwood,/area/library)
"bg" = (/obj/structure/disposalpipe/segment{dir = 4},/turf/open/indestructible/hotelwood,/area/library)
"bh" = (/obj/machinery/door/window/eastleft,/obj/structure/disposalpipe/junction{dir = 8},/turf/open/indestructible/hotelwood,/area/library)
"bi" = (/obj/machinery/vending/coffee,/obj/structure/disposalpipe/segment{dir = 10},/turf/open/indestructible/hotelwood,/area/library)
"bj" = (/obj/machinery/atmospherics/pipe/simple/supply/hidden,/turf/open/indestructible/hotelwood,/area/library/lounge)
"bk" = (/obj/machinery/atmospherics/pipe/simple/scrubbers/hidden{dir = 5},/turf/open/indestructible/hotelwood,/area/library/lounge)
"bl" = (/obj/machinery/atmospherics/pipe/simple/scrubbers/hidden{dir = 4},/turf/open/indestructible/hotelwood,/area/library/lounge)
"bm" = (/obj/structure/table/wood/fancy/green,/obj/machinery/atmospherics/pipe/simple/scrubbers/hidden{dir = 4},/turf/open/indestructible/hotelwood,/area/library)
"bn" = (/obj/structure/table/wood/fancy/green,/obj/machinery/atmospherics/pipe/manifold/scrubbers/hidden{dir = 1},/turf/open/indestructible/hotelwood,/area/library)
"bo" = (/obj/machinery/atmospherics/pipe/simple/scrubbers/hidden{dir = 4},/turf/open/indestructible/hotelwood,/area/library)
"bp" = (/obj/structure/table/wood/fancy/red,/obj/machinery/atmospherics/components/unary/vent_scrubber/on{dir = 8},/turf/open/floor/carpet/green,/area/library)
"bq" = (/obj/machinery/computer/libraryconsole{pixel_y = 8},/obj/structure/table/wood/fancy/red,/turf/open/floor/carpet/green,/area/library)
"br" = (/turf/open/floor/carpet/green,/area/library)
"bs" = (/obj/machinery/disposal/bin,/obj/structure/disposalpipe/trunk{dir = 1},/turf/open/indestructible/hotelwood,/area/library)
"bt" = (/obj/machinery/atmospherics/pipe/simple/supply/hidden,/turf/open/indestructible/hotelwood,/area/library)
"bu" = (/obj/machinery/atmospherics/pipe/simple/scrubbers/hidden,/turf/open/indestructible,/area/library)
"bv" = (/obj/machinery/photocopier,/turf/open/floor/carpet/green,/area/library)
"bw" = (/obj/structure/chair/wood{icon_state = "wooden_chair"; dir = 1},/turf/open/floor/carpet/green,/area/library)
"bx" = (/obj/machinery/atmospherics/pipe/simple/scrubbers/hidden,/turf/open/floor/carpet/red,/area/library)
"by" = (/obj/effect/spawner/structure/window/reinforced/indestructable,/turf/open/floor/plating,/area/library)
"bz" = (/obj/machinery/atmospherics/pipe/simple/supply/hidden{dir = 5},/turf/open/indestructible/hotelwood,/area/library)
"bA" = (/obj/machinery/atmospherics/pipe/simple/supply/hidden{dir = 4},/turf/open/indestructible/hotelwood,/area/library)
"bB" = (/obj/structure/displaycase/clown,/obj/machinery/atmospherics/pipe/simple/scrubbers/hidden{dir = 4},/turf/open/indestructible,/area/library)
"bC" = (/obj/structure/displaycase/captain,/obj/machinery/atmospherics/pipe/simple/scrubbers/hidden{dir = 4},/turf/open/indestructible,/area/library)
"bD" = (/obj/machinery/atmospherics/pipe/manifold/supply/hidden{dir = 1},/turf/open/indestructible,/area/library)
"bE" = (/obj/machinery/atmospherics/pipe/simple/scrubbers/hidden,/obj/machinery/atmospherics/pipe/simple/supply/hidden{dir = 4},/turf/open/indestructible,/area/library)
"bF" = (/obj/structure/displaycase/labcage,/obj/machinery/atmospherics/pipe/simple/supply/hidden{dir = 4},/turf/open/indestructible,/area/library)
"bG" = (/obj/structure/displaycase/trophy,/obj/machinery/atmospherics/pipe/simple/supply/hidden{dir = 4},/turf/open/indestructible,/area/library)
"bH" = (/obj/machinery/atmospherics/components/unary/vent_pump/on{dir = 8},/turf/open/indestructible/hotelwood,/area/library)
"bI" = (/obj/structure/toilet{icon_state = "toilet00"; dir = 8},/turf/open/indestructible/hoteltile,/area/library/lounge)
"bJ" = (/turf/open/floor/plating/asteroid/snow,/area/template_noop)
"bK" = (/obj/machinery/atmospherics/pipe/simple/supply/hidden,/turf/open/floor/plasteel/stairs/left,/area/template_noop)
"bL" = (/obj/machinery/atmospherics/pipe/simple/scrubbers/hidden,/turf/open/floor/plasteel/stairs/right,/area/template_noop)
"bM" = (/obj/machinery/atmospherics/pipe/simple/supply/hidden,/turf/template_noop,/area/template_noop)
"bN" = (/obj/machinery/atmospherics/pipe/simple/scrubbers/hidden,/turf/template_noop,/area/template_noop)
"bO" = (/obj/structure/disposalpipe/segment{dir = 6},/obj/structure/extinguisher_cabinet{pixel_x = 32; pixel_y = -32},/obj/structure/cable/yellow{icon_state = "0-4"},/obj/effect/landmark/start/librarian,/turf/open/floor/plasteel/dark,/area/library)
"bP" = (/obj/structure/disposalpipe/segment{dir = 9},/obj/structure/cable/yellow,/obj/structure/cable/yellow{icon_state = "1-8"},/obj/machinery/light/small,/turf/open/floor/plasteel/dark,/area/library)
"bQ" = (/obj/structure/disposalpipe/segment,/obj/machinery/door/airlock/maintenance{name = "Library Maintenance"; req_one_access_txt = "12;37"},/turf/open/floor/plasteel/dark,/area/library)
"bR" = (/obj/machinery/light/small{dir = 8},/turf/open/indestructible/hotelwood,/area/library/lounge)
"bS" = (/obj/machinery/libraryscanner,/obj/structure/disposalpipe/segment{dir = 4},/obj/machinery/light/small{dir = 1},/turf/open/indestructible/hotelwood,/area/library)
"bT" = (/obj/machinery/light/small{dir = 1},/turf/open/indestructible/hotelwood,/area/library)
"bU" = (/obj/structure/chair/office/light,/obj/effect/landmark/start/librarian,/turf/open/indestructible/hotelwood,/area/library)
"bV" = (/obj/machinery/atmospherics/pipe/simple/supply/hidden{dir = 4},/obj/machinery/light/small,/turf/open/indestructible/hotelwood,/area/library)
"bW" = (/obj/machinery/atmospherics/pipe/simple/supply/hidden,/obj/machinery/door/airlock/public/glass{name = "Library"},/turf/open/indestructible,/area/library)
"bX" = (/obj/machinery/atmospherics/pipe/simple/scrubbers/hidden,/obj/machinery/door/airlock/public/glass{name = "Library"},/turf/open/indestructible,/area/library)
"bY" = (/obj/machinery/light/small,/turf/open/indestructible/hotelwood,/area/library)

(1,1,1) = {"
aaaaaaaaaaaaaaaaaaaaaaaaaaaaaaaaaaaaaaaaaaaaaaaaaaaaaaaaaaaaaaaaaaaaaaaaaaaaaaaaaaaaaaaaaaaaaaaaaaaaaaaaaaaaaaaaaaaaaaaaaaaaaaaa
aaaaaaaaaaaaaaaaaaaaaaaaaaaaaaaaaaaaaaaaaaaaaaaaaaaaaaaaaaaaaaaaaaaaaaaaaaaaaaaaaaaaaaaaaaaaaaaaaaaaaaaaaaaaaaaaaaaaaaaaaaaaaaaa
aaaaaaaaaaaaaaaaaaaaaaaaaaaaaaaaaaaaaaaaaaaaaaaaaaaaaaaaaaaaaaaaaaaaaaaaaaaaaaaaaaaaaaaaaaaaaaaaaaaaaaaaaaaaaaaaaaaaaaaaaaaaaaaa
aaaaaaaaaaaaaaaaaaaaaaaaaaaaaaaaaaaaaaaaaaaaaaaaaaaaaaaaaaaaaaaaaaaaaaaaaaaaaaaaaaaaaaaaaaaaaaaaaaaaaaaaaaaaaaaaaaaaaaaaaaaaaaaa
aaaaaaaaaaaaaaaaaaaaaaaaaaaaaaaaaaaaaaaaaaaaaaaaaaaaaaaaaaaaaaaaaaaaaaaaaaaaaaaaaaaaaaaaaaaaaaaaaaaaaaaaaaaaaaaaaaaaaaaaaaaaaaaa
aaaaaaaaaaaaaaaaaaaaaaaaaaaaaaaaaaaaaaaaaaaaaaaaaaaaaaaaaaaaaaaaaaaaaaaaaaaaaaaaaaaaaaaaaaaaaaaaaaaaaaaaaaaaaaaaaaaaaaaaaaaaaaaa
aaaaaaaaaaaaaaaaaaaaaaaaaaaaaaaaaaaaaaaaaaabababababababababababacacafahacacacacacacacaaaaaaaaaaaaaaaaaaaaaaaaaaaaaaaaaaaaaaaaaa
aaaaaaaaaaaaaaaaaaaaaaaaaaaaaaaaaaaaaaaaaaabalaeaeawaeaeaoaxaJabaPaqadaracagaiacajakacaaaaaaaaaaaaaaaaaaaaaaaaaaaaaaaaaaaaaaaaaa
aaaaaaaaaaaaaaaaaaaaaaaaaaaaaaaaaaaaaaaaaaabaeasavavasaeabaYbIabbOaDbPaqacamanacanamacaaaaaaaaaaaaaaaaaaaaaaaaaaaaaaaaaaaaaaaaaa
aaaaaaaaaaaaaaaaaaaaaaaaaaaaaaaaaaaaaaaaaaabaeaKapaMaNaOababababbQacacacacacaQacaRacacaaaaaaaaaaaaaaaaaaaaaaaaaaaaaaaaaaaaaaaaaa
aaaaaaaaaaaaaaaaaaaaaaaaaaaaaaaaaaaaaaaaaaabbRaKaSaTaUaVaWaXbSaZbaaubbatatatatbTatatacaaaaaaaaaaaaaaaaaaaaaaaaaaaaaaaaaaaaaaaaaa
aaaaaaaaaaaaaaaaaaaaaaaaaaaaaaaaaaaaaaaaaaabaeasbcbdasaVaebeatbUbfbgbhbgbgbgbgbgbgbiacaaaaaaaaaaaaaaaaaaaaaaaaaaaaaaaaaaaaaaaaaa
aaaaaaaaaaaaaaaaaaaaaaaaaaaaaaaaaaaaaaaaaaabaeaeaebjaebkblbmbmbmbnbmbmbobobpbqbratbsacaaaaaaaaaaaaaaaaaaaaaaaaaaaaaaaaaaaaaaaaaa
aaaaaaaaaaaaaaaaaaaaaaaaaaaaaaaaaaaaaaaaaaacayatazbtazatataAaAaAbuaAaAatatbvbwbrataBacaaaaaaaaaaaaaaaaaaaaaaaaaaaaaaaaaaaaaaaaaa
aaaaaaaaaaaaaaaaaaaaaaaaaaaaaaaaaaaaaaaaaaacayatazbtazatataAaCaCbxaCaAatatbrbrbrataBacaaaaaaaaaaaaaaaaaaaaaaaaaaaaaaaaaaaaaaaaaa
aaaaaaaaaaaaaaaaaaaaaaaaaaaaaaaaaaaaaaaaaaacayatazbtazatataAaCaCbxaCaAatatatatatataBacaaaaaaaaaaaaaaaaaaaaaaaaaaaaaaaaaaaaaaaaaa
aaaaaaaaaaaaaaaaaaaaaaaaaaaaaaaaaaaaaaaaaabyatatatbzbAbAbVbBbCbDbEbFbGbVbAbAbAbAbAbHbyaaaaaaaaaaaaaaaaaaaaaaaaaaaaaaaaaaaaaaaaaa
aaaaaaaaaaaaaaaaaaaaaaaaaaaaaaaaaaaaaaaaaaacaEataEataFatacacacbWbXacacacataBataBataGacaaaaaaaaaaaaaaaaaaaaaaaaaaaaaaaaaaaaaaaaaa
aaaaaaaaaaaaaaaaaaaaaaaaaaaaaaaaaaaaaaaaaaacaEataEataHatacbJbJbKbLbJbJacataBataBataGacaaaaaaaaaaaaaaaaaaaaaaaaaaaaaaaaaaaaaaaaaa
aaaaaaaaaaaaaaaaaaaaaaaaaaaaaaaaaaaaaaaaaaacaEataEataLatbybJaIbMbNaIbJbyataBataBataGacaaaaaaaaaaaaaaaaaaaaaaaaaaaaaaaaaaaaaaaaaa
aaaaaaaaaaaaaaaaaaaaaaaaaaaaaaaaaaaaaaaaaaacatatatbYatatacbJaIbMbNaIbJacatatbYatatatacaaaaaaaaaaaaaaaaaaaaaaaaaaaaaaaaaaaaaaaaaa
aaaaaaaaaaaaaaaaaaaaaaaaaaaaaaaaaaaaaaaaaaacacbyacacbyacacbJaIbMbNaIbJacacbyacacbyacacaaaaaaaaaaaaaaaaaaaaaaaaaaaaaaaaaaaaaaaaaa
"}
