//MAP CONVERTED BY dmm2tgm.py THIS HEADER COMMENT PREVENTS RECONVERSION, DO NOT REMOVE
"a" = (
/turf/closed/mineral/volcanic/lava_land_surface,
/area/lavaland/surface/outdoors)
"b" = (
/turf/open/floor/plating/asteroid/basalt/lava_land_surface,
/area/lavaland/surface/outdoors)
"c" = (
/obj/structure/table/wood,
/turf/open/floor/plasteel/freezer,
/area/ruin/lavaland/powered/seedvault)
"d" = (
/obj/structure/table/wood,
/obj/item/lighter,
/obj/item/lighter,
/obj/item/storage/fancy/rollingpapers,
/obj/item/storage/fancy/rollingpapers,
/obj/item/storage/fancy/rollingpapers,
/obj/item/storage/fancy/rollingpapers,
/turf/open/floor/plasteel/freezer,
/area/ruin/lavaland/powered/seedvault)
"e" = (
/obj/structure/table/wood,
/obj/item/storage/box/disks_plantgene,
/turf/open/floor/plasteel/freezer,
/area/ruin/lavaland/powered/seedvault)
"f" = (
/obj/structure/sink{
	dir = 4;
	pixel_x = 11
	},
/turf/open/floor/grass,
/area/ruin/lavaland/powered/seedvault)
"g" = (
/obj/structure/table/wood,
/obj/machinery/smartfridge/disks{
	pixel_y = 2
	},
/turf/open/floor/plasteel/freezer,
/area/ruin/lavaland/powered/seedvault)
"h" = (
/turf/open/floor/plasteel/freezer,
/area/ruin/lavaland/powered/seedvault)
"i" = (
/obj/structure/closet/crate/hydroponics,
/obj/structure/beebox,
/obj/item/melee/flyswatter,
/obj/item/honey_frame,
/obj/item/honey_frame,
/obj/item/honey_frame,
/obj/item/queen_bee/bought,
/obj/item/clothing/head/beekeeper_head,
/obj/item/clothing/suit/beekeeper_suit,
/turf/open/floor/plasteel/freezer,
/area/ruin/lavaland/powered/seedvault)
"j" = (
/obj/structure/shuttle/engine/propulsion{
	dir = 8
	},
/turf/open/floor/plating/asteroid/basalt/lava_land_surface,
/area/lavaland/surface/outdoors)
"k" = (
/obj/structure/closet/crate,
/obj/effect/spawner/lootdrop/seed_vault,
/turf/open/floor/plasteel/freezer,
/area/ruin/lavaland/powered/seedvault)
"l" = (
/obj/machinery/door/airlock/titanium/glass,
/turf/open/floor/plasteel/freezer,
/area/ruin/lavaland/powered/seedvault)
"m" = (
/obj/machinery/door/airlock/external,
/obj/structure/fans/tiny,
/obj/effect/mapping_helpers/airlock/cyclelink_helper{
	dir = 8
	},
/turf/open/floor/plasteel/freezer,
/area/ruin/lavaland/powered/seedvault)
"n" = (
/obj/structure/table/wood,
/obj/item/gps,
/turf/open/floor/plasteel/freezer,
/area/ruin/lavaland/powered/seedvault)
"o" = (
/obj/structure/closet/crate/hydroponics,
/obj/item/cultivator,
/obj/item/cultivator,
/obj/item/cultivator,
/obj/item/cultivator,
/obj/item/shovel/spade,
/obj/item/shovel/spade,
/obj/item/shovel/spade,
/obj/item/shovel/spade,
/obj/item/hatchet,
/obj/item/hatchet,
/obj/item/hatchet,
/obj/item/hatchet,
/turf/open/floor/plasteel/freezer,
/area/ruin/lavaland/powered/seedvault)
"p" = (
/obj/structure/grille,
/obj/machinery/smartfridge,
/turf/open/floor/circuit/green,
/area/ruin/lavaland/powered/seedvault)
"q" = (
/obj/item/hatchet,
/obj/item/storage/bag/plants,
/obj/item/reagent_containers/glass/bucket,
/obj/structure/table/wood,
/turf/open/floor/plasteel/freezer,
/area/ruin/lavaland/powered/seedvault)
"r" = (
/obj/structure/table/wood,
/obj/item/storage/bag/plants,
/obj/item/storage/bag/plants,
/obj/item/storage/bag/plants,
/obj/item/storage/bag/plants,
/turf/open/floor/plasteel/freezer,
/area/ruin/lavaland/powered/seedvault)
"s" = (
/obj/structure/table/wood,
/obj/item/seeds/bee_balm/honey_balm,
/turf/open/floor/plasteel/freezer,
/area/ruin/lavaland/powered/seedvault)
"t" = (
/obj/effect/mob_spawn/human/seed_vault,
/turf/open/floor/grass,
/area/ruin/lavaland/powered/seedvault)
"u" = (
/turf/open/floor/grass,
/area/ruin/lavaland/powered/seedvault)
"v" = (
/obj/machinery/vending/hydronutrients,
/turf/open/floor/plasteel/freezer,
/area/ruin/lavaland/powered/seedvault)
"w" = (
/obj/machinery/vending/hydroseeds,
/turf/open/floor/plasteel/freezer,
/area/ruin/lavaland/powered/seedvault)
"x" = (
/obj/machinery/reagentgrinder{
	pixel_y = 5
	},
/obj/structure/table/glass,
/obj/item/reagent_containers/glass/beaker/bluespace,
/obj/item/reagent_containers/glass/beaker/bluespace,
/obj/item/reagent_containers/glass/beaker/bluespace,
/obj/item/reagent_containers/glass/beaker/bluespace,
/turf/open/floor/plasteel/freezer,
/area/ruin/lavaland/powered/seedvault)
"y" = (
/obj/structure/table/wood,
/obj/item/pickaxe,
/turf/open/floor/plasteel/freezer,
/area/ruin/lavaland/powered/seedvault)
"z" = (
/obj/machinery/door/airlock/external,
/obj/effect/mapping_helpers/airlock/cyclelink_helper{
	dir = 4
	},
/turf/open/floor/plasteel/freezer,
/area/ruin/lavaland/powered/seedvault)
"A" = (
/obj/structure/table/glass,
/turf/open/floor/plasteel/freezer,
/area/ruin/lavaland/powered/seedvault)
"B" = (
/obj/structure/disposalpipe/trunk,
/obj/machinery/disposal/bin,
/turf/open/floor/plasteel/freezer,
/area/ruin/lavaland/powered/seedvault)
"C" = (
/obj/machinery/seed_extractor,
/turf/open/floor/plasteel/freezer,
/area/ruin/lavaland/powered/seedvault)
"D" = (
/obj/machinery/biogenerator,
/turf/open/floor/plasteel/freezer,
/area/ruin/lavaland/powered/seedvault)
"E" = (
/obj/machinery/chem_dispenser/mutagensaltpeter,
/turf/open/floor/plasteel/freezer,
/area/ruin/lavaland/powered/seedvault)
"F" = (
/obj/structure/grille,
/obj/structure/window/shuttle,
/turf/open/floor/circuit/green,
/area/ruin/lavaland/powered/seedvault)
"G" = (
/obj/structure/disposalpipe/segment,
/turf/closed/wall/mineral/titanium/interior,
/area/ruin/lavaland/powered/seedvault)
"H" = (
/obj/structure/table/glass,
/obj/item/gun/energy/floragun,
/obj/item/gun/energy/floragun,
/obj/item/gun/energy/floragun,
/obj/item/gun/energy/floragun,
/turf/open/floor/plasteel/freezer,
/area/ruin/lavaland/powered/seedvault)
"I" = (
/obj/structure/table/wood,
/obj/item/watertank,
/turf/open/floor/plasteel/freezer,
/area/ruin/lavaland/powered/seedvault)
"J" = (
/obj/item/storage/toolbox/syndicate,
/obj/structure/table/wood,
/turf/open/floor/plasteel/freezer,
/area/ruin/lavaland/powered/seedvault)
"K" = (
/obj/machinery/light{
	dir = 1
	},
/obj/structure/flora/ausbushes/ywflowers,
/turf/open/floor/grass,
/area/ruin/lavaland/powered/seedvault)
"L" = (
/obj/structure/disposalpipe/segment{
	dir = 5
	},
/turf/open/floor/plating/asteroid/basalt/lava_land_surface,
/area/lavaland/surface/outdoors)
"M" = (
/obj/structure/disposalpipe/trunk{
	dir = 8
	},
/turf/open/floor/plating/asteroid/basalt/lava_land_surface,
/area/lavaland/surface/outdoors)
"N" = (
/obj/machinery/plantgenes/seedvault{
	pixel_y = 6
	},
/obj/structure/table/wood,
/obj/machinery/light{
	dir = 1
	},
/turf/open/floor/plasteel/freezer,
/area/ruin/lavaland/powered/seedvault)
"O" = (
/obj/machinery/light{
	dir = 1
	},
/turf/open/floor/plasteel/freezer,
/area/ruin/lavaland/powered/seedvault)
"P" = (
/obj/structure/table/wood,
/obj/item/storage/box/disks_plantgene,
/obj/machinery/light,
/turf/open/floor/plasteel/freezer,
/area/ruin/lavaland/powered/seedvault)
"Q" = (
/obj/machinery/hydroponics/constructable,
/turf/open/floor/grass,
/area/ruin/lavaland/powered/seedvault)
"R" = (
/obj/structure/sink{
	dir = 8;
	pixel_x = -12;
	pixel_y = 2
	},
/turf/open/floor/grass,
/area/ruin/lavaland/powered/seedvault)
"S" = (
/turf/closed/wall/mineral/titanium/interior,
/area/ruin/lavaland/powered/seedvault)
"T" = (
/obj/structure/closet/crate/hydroponics,
/obj/item/clothing/under/rank/civilian/hydroponics,
/obj/item/clothing/under/rank/civilian/hydroponics,
/obj/item/clothing/under/rank/civilian/hydroponics,
/obj/item/clothing/under/rank/civilian/hydroponics,
/obj/machinery/light,
/turf/open/floor/plasteel/freezer,
/area/ruin/lavaland/powered/seedvault)
"U" = (
/obj/machinery/light,
/obj/structure/flora/ausbushes/ppflowers,
/turf/open/floor/grass,
/area/ruin/lavaland/powered/seedvault)
"V" = (
/obj/structure/table/wood,
/obj/item/reagent_containers/glass/bucket,
/obj/item/reagent_containers/glass/bucket,
/obj/item/reagent_containers/glass/bucket,
/obj/item/reagent_containers/glass/bucket,
/obj/machinery/light,
/turf/open/floor/plasteel/freezer,
/area/ruin/lavaland/powered/seedvault)
"X" = (
/obj/structure/table/glass,
/obj/item/construction/plumbing,
/obj/machinery/light{
	dir = 1
	},
/turf/open/floor/plasteel/freezer,
/area/ruin/lavaland/powered/seedvault)
"Y" = (
/obj/machinery/chem_master,
/turf/open/floor/plasteel/freezer,
/area/ruin/lavaland/powered/seedvault)
"Z" = (
/obj/item/disk/design_disk/plant_disk,
/obj/machinery/autolathe/hacked{
	desc = "This autolathe seems to have its safety light off."
	},
/turf/open/floor/plasteel/freezer,
/area/ruin/lavaland/powered/seedvault)

(1,1,1) = {"
a
a
a
a
a
a
a
S
S
S
S
S
S
a
a
a
a
a
b
b
"}
(2,1,1) = {"
a
a
a
a
a
a
S
S
t
t
t
t
S
S
a
a
a
a
b
b
"}
(3,1,1) = {"
b
a
a
a
S
S
S
S
K
u
u
U
S
S
S
S
a
a
a
b
"}
(4,1,1) = {"
b
a
a
S
S
w
v
S
F
l
l
F
S
w
v
S
S
a
a
a
"}
(5,1,1) = {"
a
a
S
S
u
u
u
R
u
h
h
u
R
u
u
u
S
S
a
a
"}
(6,1,1) = {"
a
a
S
C
u
Q
u
Q
u
h
h
u
Q
u
Q
u
Z
S
a
a
"}
(7,1,1) = {"
a
a
S
N
u
Q
u
Q
u
h
h
u
Q
u
Q
u
V
S
a
a
"}
(8,1,1) = {"
b
a
S
g
u
Q
u
Q
u
h
h
u
Q
u
Q
u
B
G
L
a
"}
(9,1,1) = {"
b
a
S
e
u
u
u
f
u
h
h
u
f
u
u
u
r
S
M
a
"}
(10,1,1) = {"
a
a
S
S
F
l
p
S
D
h
h
o
S
p
l
F
S
S
b
a
"}
(11,1,1) = {"
a
a
S
k
h
h
e
S
O
h
h
T
S
H
h
h
E
S
a
a
"}
(12,1,1) = {"
b
a
S
k
h
h
P
S
I
h
h
J
S
X
h
h
A
S
a
a
"}
(13,1,1) = {"
a
a
S
k
h
h
d
S
c
h
h
n
S
x
h
h
Y
S
a
a
"}
(14,1,1) = {"
a
a
S
S
i
i
s
S
q
h
h
y
S
A
h
h
S
S
a
a
"}
(15,1,1) = {"
a
a
a
S
S
S
S
S
S
z
z
S
S
S
S
S
S
a
a
a
"}
(16,1,1) = {"
b
a
a
j
S
j
S
j
S
h
h
S
j
S
j
S
j
a
a
a
"}
(17,1,1) = {"
a
a
a
a
a
a
a
a
S
m
m
S
b
b
b
a
a
a
b
b
"}
(18,1,1) = {"
a
a
a
b
b
b
b
b
b
b
b
b
b
b
b
a
a
a
b
b
"}
(19,1,1) = {"
a
a
a
a
b
b
b
b
b
b
b
b
b
b
a
a
a
b
b
b
"}
(20,1,1) = {"
a
a
a
b
b
b
a
b
b
b
b
b
b
b
a
a
a
b
b
a
"}
