"aa" = (/turf/template_noop,/area/template_noop)
"ab" = (/turf/open/floor/plating/asteroid/basalt/lava_land_surface,/area/lavaland/surface/outdoors)
"ac" = (/turf/open/floor/grass{baseturf = /turf/open/floor/plating/lava/smooth/lava_land_surface; initial_gas_mix = "o2=14;n2=23;TEMP=300"},/area/lavaland/surface/outdoors)
"ad" = (/obj/machinery/atmospherics/pipe/simple/general/visible{dir = 6},/turf/open/floor/grass{baseturf = /turf/open/floor/plating/lava/smooth/lava_land_surface; initial_gas_mix = "o2=14;n2=23;TEMP=300"},/area/lavaland/surface/outdoors)
"ae" = (/obj/machinery/atmospherics/pipe/manifold/general/visible{dir = 1},/turf/open/floor/grass{baseturf = /turf/open/floor/plating/lava/smooth/lava_land_surface; initial_gas_mix = "o2=14;n2=23;TEMP=300"},/area/lavaland/surface/outdoors)
"af" = (/obj/machinery/atmospherics/pipe/simple/general/visible{dir = 10},/turf/open/floor/grass{baseturf = /turf/open/floor/plating/lava/smooth/lava_land_surface; initial_gas_mix = "o2=14;n2=23;TEMP=300"},/area/lavaland/surface/outdoors)
"ag" = (/obj/structure/flora/ausbushes/brflowers,/turf/open/floor/grass{baseturf = /turf/open/floor/plating/lava/smooth/lava_land_surface; initial_gas_mix = "o2=14;n2=23;TEMP=300"},/area/lavaland/surface/outdoors)
"ah" = (/obj/machinery/atmospherics/components/unary/tank/air{dir = 4},/turf/open/floor/grass{baseturf = /turf/open/floor/plating/lava/smooth/lava_land_surface; initial_gas_mix = "o2=14;n2=23;TEMP=300"},/area/lavaland/surface/outdoors)
"ai" = (/obj/machinery/atmospherics/components/binary/valve,/turf/open/floor/grass{baseturf = /turf/open/floor/plating/lava/smooth/lava_land_surface; initial_gas_mix = "o2=14;n2=23;TEMP=300"},/area/lavaland/surface/outdoors)
"aj" = (/turf/closed/wall/shuttle/smooth{baseturf = /turf/open/floor/plating/lava/smooth/lava_land_surface},/area/ruin/powered)
"ak" = (/obj/structure/grille,/obj/structure/window/fulltile,/turf/open/floor/plating{baseturf = /turf/open/floor/plating/lava/smooth/lava_land_surface},/area/ruin/powered)
"al" = (/obj/machinery/atmospherics/pipe/simple/general/visible,/turf/closed/wall/shuttle/smooth{baseturf = /turf/open/floor/plating/lava/smooth/lava_land_surface},/area/ruin/powered)
"am" = (/turf/open/floor/plasteel/bar{baseturf = /turf/open/floor/plating/lava/smooth/lava_land_surface},/area/ruin/powered)
"an" = (/obj/structure/toilet,/turf/open/floor/plasteel/bar{baseturf = /turf/open/floor/plating/lava/smooth/lava_land_surface},/area/ruin/powered)
"ao" = (/obj/machinery/vending/coffee,/turf/open/floor/plasteel/cmo{baseturf = /turf/open/floor/plating/lava/smooth/lava_land_surface},/area/ruin/powered)
"ap" = (/obj/structure/table/wood,/obj/item/device/flashlight/lamp,/turf/open/floor/plasteel/cmo{baseturf = /turf/open/floor/plating/lava/smooth/lava_land_surface},/area/ruin/powered)
"aq" = (/obj/structure/table/wood,/obj/item/device/taperecorder,/obj/item/weapon/pen/blue,/turf/open/floor/plasteel/cmo{baseturf = /turf/open/floor/plating/lava/smooth/lava_land_surface},/area/ruin/powered)
"ar" = (/obj/structure/table/wood,/obj/item/toy/carpplushie,/turf/open/floor/plasteel/cmo{baseturf = /turf/open/floor/plating/lava/smooth/lava_land_surface},/area/ruin/powered)
"as" = (/obj/machinery/vending/snack,/turf/open/floor/plasteel/cmo{baseturf = /turf/open/floor/plating/lava/smooth/lava_land_surface},/area/ruin/powered)
"at" = (/obj/structure/table/reinforced,/obj/item/clothing/gloves/color/latex,/obj/item/clothing/mask/surgical,/obj/item/clothing/suit/apron/surgical,/turf/open/floor/plasteel/white{baseturf = /turf/open/floor/plating/lava/smooth/lava_land_surface},/area/ruin/powered)
"au" = (/obj/machinery/atmospherics/components/unary/portables_connector/visible{dir = 1},/obj/machinery/portable_atmospherics/pump,/turf/open/floor/plasteel/white{baseturf = /turf/open/floor/plating/lava/smooth/lava_land_surface},/area/ruin/powered)
"av" = (/obj/structure/table,/obj/item/weapon/circular_saw,/obj/item/weapon/scalpel{pixel_y = 12},/turf/open/floor/plasteel/white{baseturf = /turf/open/floor/plating/lava/smooth/lava_land_surface},/area/ruin/powered)
"aw" = (/obj/structure/table,/obj/item/weapon/cautery{pixel_x = 4},/obj/item/weapon/surgicaldrill,/turf/open/floor/plasteel/white{baseturf = /turf/open/floor/plating/lava/smooth/lava_land_surface},/area/ruin/powered)
"ax" = (/obj/structure/table,/obj/item/weapon/surgical_drapes,/obj/item/weapon/razor,/turf/open/floor/plasteel/white{baseturf = /turf/open/floor/plating/lava/smooth/lava_land_surface},/area/ruin/powered)
"ay" = (/turf/open/floor/plasteel/cmo{baseturf = /turf/open/floor/plating/lava/smooth/lava_land_surface},/area/ruin/powered)
"az" = (/obj/structure/chair/office/dark{dir = 1},/turf/open/floor/plasteel/cmo{baseturf = /turf/open/floor/plating/lava/smooth/lava_land_surface},/area/ruin/powered)
"aA" = (/obj/structure/chair/office/dark{dir = 4},/turf/open/floor/plasteel/cmo{baseturf = /turf/open/floor/plating/lava/smooth/lava_land_surface},/area/ruin/powered)
"aB" = (/obj/machinery/sleeper{icon_state = "sleeper-open"; dir = 4},/turf/open/floor/plasteel/white{baseturf = /turf/open/floor/plating/lava/smooth/lava_land_surface},/area/ruin/powered)
"aC" = (/turf/open/floor/plasteel/white{baseturf = /turf/open/floor/plating/lava/smooth/lava_land_surface},/area/ruin/powered)
"aD" = (/obj/structure/bed/roller,/turf/open/floor/plasteel/white{baseturf = /turf/open/floor/plating/lava/smooth/lava_land_surface},/area/ruin/powered)
"aE" = (/obj/structure/closet/crate/trashcart,/obj/item/weapon/storage/bag/trash,/obj/item/trash/cheesie,/obj/item/weapon/reagent_containers/syringe/antiviral,/obj/item/bodybag,/obj/item/weapon/reagent_containers/food/drinks/bottle/vodka,/turf/open/floor/grass{baseturf = /turf/open/floor/plating/lava/smooth/lava_land_surface; initial_gas_mix = "o2=14;n2=23;TEMP=300"},/area/lavaland/surface/outdoors)
"aF" = (/obj/structure/sink{icon_state = "sink"; dir = 8; pixel_x = -12; pixel_y = 2},/obj/structure/mirror{pixel_x = -28},/turf/open/floor/plasteel/bar{baseturf = /turf/open/floor/plating/lava/smooth/lava_land_surface},/area/ruin/powered)
"aG" = (/obj/structure/noticeboard{dir = 1; pixel_y = -27},/obj/item/weapon/paper{info = "Nothing of interest to report."; name = "Important Notice - Mrs. Henderson"},/turf/open/floor/plasteel/cmo{baseturf = /turf/open/floor/plating/lava/smooth/lava_land_surface},/area/ruin/powered)
"aH" = (/obj/structure/closet/secure_closet/medical2,/turf/open/floor/plasteel/white{baseturf = /turf/open/floor/plating/lava/smooth/lava_land_surface},/area/ruin/powered)
"aI" = (/obj/machinery/computer/operating,/turf/open/floor/plasteel/white{baseturf = /turf/open/floor/plating/lava/smooth/lava_land_surface},/area/ruin/powered)
"aJ" = (/obj/structure/table/optable,/turf/open/floor/plasteel/white{baseturf = /turf/open/floor/plating/lava/smooth/lava_land_surface},/area/ruin/powered)
"aK" = (/obj/structure/table,/obj/item/weapon/retractor,/obj/item/weapon/hemostat,/turf/open/floor/plasteel/white{baseturf = /turf/open/floor/plating/lava/smooth/lava_land_surface},/area/ruin/powered)
"aL" = (/turf/closed/wall/shuttle/smooth/nodiagonal{baseturf = /turf/open/floor/plating/lava/smooth/lava_land_surface},/area/ruin/powered)
"aM" = (/obj/machinery/door/unpowered/shuttle{name = "Restroom"},/turf/open/floor/plasteel/bar{baseturf = /turf/open/floor/plating/lava/smooth/lava_land_surface},/area/ruin/powered)
"aN" = (/obj/structure/extinguisher_cabinet,/turf/closed/wall/shuttle/smooth{baseturf = /turf/open/floor/plating/lava/smooth/lava_land_surface},/area/ruin/powered)
"aO" = (/obj/machinery/door/unpowered/shuttle{name = "Break Room"},/turf/open/floor/plasteel/cmo{baseturf = /turf/open/floor/plating/lava/smooth/lava_land_surface},/area/ruin/powered)
"aP" = (/obj/structure/extinguisher_cabinet,/turf/closed/wall/shuttle/smooth/nodiagonal{baseturf = /turf/open/floor/plating/lava/smooth/lava_land_surface},/area/ruin/powered)
"aQ" = (/obj/machinery/door/unpowered/shuttle{name = "Emergency Care"},/turf/open/floor/plasteel/white{baseturf = /turf/open/floor/plating/lava/smooth/lava_land_surface},/area/ruin/powered)
"aR" = (/turf/closed/wall/shuttle/smooth,/area/ruin/powered)
"aS" = (/turf/open/floor/plasteel/grimy{baseturf = /turf/open/floor/plating/lava/smooth/lava_land_surface},/area/lavaland/surface/outdoors)
"aT" = (/obj/machinery/door/unpowered/shuttle{desc = "There's a note wedged in the seam saying something about directing pizza here."; name = "Staff Entrance"},/turf/open/floor/plating{baseturf = /turf/open/floor/plating/lava/smooth/lava_land_surface},/area/ruin/powered)
"aU" = (/turf/open/floor/plasteel{baseturf = /turf/open/floor/plating/lava/smooth/lava_land_surface},/area/ruin/powered)
"aV" = (/turf/open/floor/plasteel/blue/side{baseturf = /turf/open/floor/plating/lava/smooth/lava_land_surface; dir = 1},/area/ruin/powered)
"aW" = (/obj/effect/mob_spawn/human/doctor/alive/lavaland,/turf/open/floor/plasteel/blue/side{baseturf = /turf/open/floor/plating/lava/smooth/lava_land_surface; dir = 1},/area/ruin/powered)
"aX" = (/obj/structure/closet/crate/freezer,/obj/item/weapon/reagent_containers/blood/random,/obj/item/weapon/reagent_containers/blood/random,/obj/item/weapon/reagent_containers/blood/random,/obj/item/weapon/reagent_containers/blood/random,/turf/open/floor/plasteel/blue/side{baseturf = /turf/open/floor/plating/lava/smooth/lava_land_surface; dir = 1},/area/ruin/powered)
"aY" = (/obj/machinery/iv_drip,/turf/open/floor/plasteel/blue/side{baseturf = /turf/open/floor/plating/lava/smooth/lava_land_surface; dir = 1},/area/ruin/powered)
"aZ" = (/turf/open/floor/plasteel/blue/side{baseturf = /turf/open/floor/plating/lava/smooth/lava_land_surface; dir = 0},/area/ruin/powered)
"ba" = (/turf/open/floor/plasteel/blue/corner{baseturf = /turf/open/floor/plating/lava/smooth/lava_land_surface; dir = 8},/area/ruin/powered)
"bb" = (/turf/open/floor/plasteel/blue/side{baseturf = /turf/open/floor/plating/lava/smooth/lava_land_surface; dir = 4},/area/ruin/powered)
"bc" = (/obj/machinery/door/unpowered/shuttle{name = "Morgue"},/turf/open/floor/plating{baseturf = /turf/open/floor/plating/lava/smooth/lava_land_surface},/area/ruin/powered)
"bd" = (/obj/machinery/door/unpowered/shuttle{name = "Medical Supplies"},/turf/open/floor/plasteel/white{baseturf = /turf/open/floor/plating/lava/smooth/lava_land_surface},/area/ruin/powered)
"be" = (/obj/machinery/door/unpowered/shuttle{name = "Safety Supplies"},/turf/open/floor/plasteel/white{baseturf = /turf/open/floor/plating/lava/smooth/lava_land_surface},/area/ruin/powered)
"bf" = (/obj/machinery/door/unpowered/shuttle{name = "Tool Storage"},/turf/open/floor/plating{baseturf = /turf/open/floor/plating/lava/smooth/lava_land_surface},/area/ruin/powered)
"bg" = (/turf/open/floor/plasteel/blue/side{baseturf = /turf/open/floor/plating/lava/smooth/lava_land_surface; dir = 8},/area/ruin/powered)
"bh" = (/obj/structure/closet,/obj/effect/decal/cleanable/cobweb,/obj/item/ammo_casing/shotgun/dart,/obj/item/ammo_casing/shotgun/dart,/obj/item/weapon/gun/projectile/revolver/doublebarrel{desc = "For putting critters out to pasture."},/obj/item/ammo_casing/shotgun/buckshot,/obj/item/weapon/storage/box/bodybags,/turf/open/floor/plating{baseturf = /turf/open/floor/plating/lava/smooth/lava_land_surface},/area/ruin/powered)
"bi" = (/turf/open/floor/plating{baseturf = /turf/open/floor/plating/lava/smooth/lava_land_surface},/area/ruin/powered)
"bj" = (/obj/structure/closet/secure_closet/medical1,/turf/open/floor/plasteel/white{baseturf = /turf/open/floor/plating/lava/smooth/lava_land_surface},/area/ruin/powered)
"bk" = (/obj/machinery/vending/wallmed{pixel_y = 28},/turf/open/floor/plasteel/white{baseturf = /turf/open/floor/plating/lava/smooth/lava_land_surface},/area/ruin/powered)
"bl" = (/obj/structure/closet/l3closet,/turf/open/floor/plasteel/white{baseturf = /turf/open/floor/plating/lava/smooth/lava_land_surface},/area/ruin/powered)
"bm" = (/obj/item/stack/cable_coil/random,/turf/open/floor/plating{baseturf = /turf/open/floor/plating/lava/smooth/lava_land_surface},/area/ruin/powered)
"bn" = (/obj/structure/bodycontainer/morgue,/turf/open/floor/plating{baseturf = /turf/open/floor/plating/lava/smooth/lava_land_surface},/area/ruin/powered)
"bo" = (/obj/effect/decal/cleanable/ash,/turf/open/floor/plating{baseturf = /turf/open/floor/plating/lava/smooth/lava_land_surface},/area/ruin/powered)
"bp" = (/obj/structure/table/glass,/obj/item/weapon/reagent_containers/glass/beaker,/obj/item/weapon/storage/backpack/dufflebag/med,/turf/open/floor/plasteel/white{baseturf = /turf/open/floor/plating/lava/smooth/lava_land_surface},/area/ruin/powered)
"bq" = (/obj/structure/table/reinforced,/obj/item/device/laser_pointer,/turf/open/floor/plasteel/white{baseturf = /turf/open/floor/plating/lava/smooth/lava_land_surface},/area/ruin/powered)
"br" = (/obj/structure/table/reinforced,/obj/item/weapon/storage/firstaid/regular,/turf/open/floor/plasteel/white{baseturf = /turf/open/floor/plating/lava/smooth/lava_land_surface},/area/ruin/powered)
"bs" = (/obj/structure/table/glass,/obj/item/weapon/storage/box/gloves,/obj/item/weapon/storage/box/masks{pixel_x = 3; pixel_y = 3},/turf/open/floor/plasteel/white{baseturf = /turf/open/floor/plating/lava/smooth/lava_land_surface},/area/ruin/powered)
"bt" = (/obj/effect/decal/cleanable/oil,/obj/item/weapon/storage/toolbox/mechanical,/turf/open/floor/plating{baseturf = /turf/open/floor/plating/lava/smooth/lava_land_surface},/area/ruin/powered)
"bu" = (/obj/structure/table,/obj/item/weapon/storage/fancy/cigarettes/dromedaryco,/obj/item/weapon/storage/box/matches,/turf/open/floor/plating{baseturf = /turf/open/floor/plating/lava/smooth/lava_land_surface},/area/ruin/powered)
"bv" = (/mob/living/simple_animal/cockroach,/turf/open/floor/plating{baseturf = /turf/open/floor/plating/lava/smooth/lava_land_surface},/area/ruin/powered)
"bw" = (/obj/structure/table/glass,/obj/item/weapon/storage/firstaid/brute,/turf/open/floor/plasteel/white{baseturf = /turf/open/floor/plating/lava/smooth/lava_land_surface},/area/ruin/powered)
"bx" = (/obj/item/toy/cattoy,/turf/open/floor/plasteel/white{baseturf = /turf/open/floor/plating/lava/smooth/lava_land_surface},/area/ruin/powered)
"by" = (/obj/structure/table/glass,/obj/item/weapon/lazarus_injector,/turf/open/floor/plasteel/white{baseturf = /turf/open/floor/plating/lava/smooth/lava_land_surface},/area/ruin/powered)
"bz" = (/obj/structure/reagent_dispensers/fueltank,/turf/open/floor/plating{baseturf = /turf/open/floor/plating/lava/smooth/lava_land_surface},/area/ruin/powered)
"bA" = (/obj/structure/table,/obj/item/weapon/reagent_containers/food/snacks/cookie{name = "doggie biscuit"},/obj/item/weapon/reagent_containers/food/snacks/cookie{name = "doggie biscuit"},/obj/item/weapon/reagent_containers/food/snacks/cookie{name = "doggie biscuit"},/obj/item/weapon/reagent_containers/food/snacks/cookie{name = "doggie biscuit"},/obj/item/weapon/reagent_containers/food/snacks/cookie{name = "doggie biscuit"},/obj/item/weapon/reagent_containers/food/snacks/cookie{name = "doggie biscuit"},/turf/open/floor/plasteel/blue/side{baseturf = /turf/open/floor/plating/lava/smooth/lava_land_surface; dir = 1},/area/ruin/powered)
"bB" = (/obj/structure/chair/comfy/teal{dir = 8},/turf/open/floor/plasteel/blue/side{baseturf = /turf/open/floor/plating/lava/smooth/lava_land_surface; dir = 1},/area/ruin/powered)
"bC" = (/obj/structure/bed/dogbed,/turf/open/floor/plasteel/white{baseturf = /turf/open/floor/plating/lava/smooth/lava_land_surface},/area/ruin/powered)
"bD" = (/obj/item/weapon/reagent_containers/glass/bowl,/obj/item/weapon/reagent_containers/food/snacks/cheesewedge,/obj/item/weapon/reagent_containers/food/snacks/cheesewedge,/turf/open/floor/plasteel/white{baseturf = /turf/open/floor/plating/lava/smooth/lava_land_surface},/area/ruin/powered)
"bE" = (/obj/item/weapon/reagent_containers/glass/rag,/obj/item/weapon/reagent_containers/spray/cleaner,/turf/open/floor/plasteel/blue/side{baseturf = /turf/open/floor/plating/lava/smooth/lava_land_surface; dir = 8},/area/ruin/powered)
"bF" = (/obj/structure/closet/crate/bin,/obj/item/trash/pistachios,/obj/item/weapon/lipstick/random,/obj/item/seeds/apple,/turf/open/floor/plasteel/blue/side{baseturf = /turf/open/floor/plating/lava/smooth/lava_land_surface; dir = 8},/area/ruin/powered)
"bG" = (/obj/structure/filingcabinet/chestdrawer/wheeled,/turf/open/floor/plasteel{baseturf = /turf/open/floor/plating/lava/smooth/lava_land_surface},/area/ruin/powered)
"bH" = (/obj/structure/chair/office/dark,/turf/open/floor/plasteel{baseturf = /turf/open/floor/plating/lava/smooth/lava_land_surface},/area/ruin/powered)
"bI" = (/obj/structure/table/reinforced,/obj/item/weapon/phone,/turf/open/floor/plasteel{baseturf = /turf/open/floor/plating/lava/smooth/lava_land_surface},/area/ruin/powered)
"bJ" = (/obj/item/weapon/twohanded/required/kirbyplants,/turf/open/floor/plasteel{baseturf = /turf/open/floor/plating/lava/smooth/lava_land_surface},/area/ruin/powered)
"bK" = (/obj/structure/chair/comfy/teal{dir = 8},/turf/open/floor/plasteel/blue/side{baseturf = /turf/open/floor/plating/lava/smooth/lava_land_surface; dir = 4},/area/ruin/powered)
"bL" = (/obj/effect/mob_spawn/mouse{dir = 4; flavour_text = "<font size=3><b>Y</b></font><b>ou're a mousey! You're getting pretty old as mice go, and you haven't been feeling well as of late. Your master loves you a lot so he took you to this place so you can get better! You can't wait to see him again!<b>"; mob_name = "Stallman Jr."},/turf/open/floor/plasteel/white{baseturf = /turf/open/floor/plating/lava/smooth/lava_land_surface},/area/ruin/powered)
"bM" = (/obj/effect/decal/cleanable/dirt,/turf/open/floor/plasteel/white{baseturf = /turf/open/floor/plating/lava/smooth/lava_land_surface},/area/ruin/powered)
"bN" = (/obj/machinery/door/airlock/medical{name = "Patient Room"; req_access_txt = "0"},/turf/open/floor/plasteel/white{baseturf = /turf/open/floor/plating/lava/smooth/lava_land_surface},/area/ruin/powered)
"bO" = (/obj/structure/table/reinforced,/obj/item/device/flashlight/lamp,/turf/open/floor/plasteel/blue/side{baseturf = /turf/open/floor/plating/lava/smooth/lava_land_surface; dir = 8},/area/ruin/powered)
"bP" = (/obj/structure/table/reinforced,/obj/item/clothing/glasses/regular,/turf/open/floor/plasteel{baseturf = /turf/open/floor/plating/lava/smooth/lava_land_surface},/area/ruin/powered)
"bQ" = (/obj/structure/table/reinforced,/obj/item/weapon/paper_bin,/obj/item/weapon/pen/fourcolor,/turf/open/floor/plasteel{baseturf = /turf/open/floor/plating/lava/smooth/lava_land_surface},/area/ruin/powered)
"bR" = (/obj/structure/table/reinforced,/obj/item/weapon/storage/box/hug,/turf/open/floor/plasteel{baseturf = /turf/open/floor/plating/lava/smooth/lava_land_surface},/area/ruin/powered)
"bS" = (/obj/structure/chair/office/light{dir = 1},/turf/open/floor/plasteel/white{baseturf = /turf/open/floor/plating/lava/smooth/lava_land_surface},/area/ruin/powered)
"bT" = (/obj/structure/table/glass,/obj/item/weapon/reagent_containers/glass/bottle/cyanide{desc = "A cocktail of chemotherpy drugs intended to treat bladder cancer."; name = "MVAC regimen"},/obj/item/weapon/reagent_containers/syringe,/turf/open/floor/plasteel/white{baseturf = /turf/open/floor/plating/lava/smooth/lava_land_surface},/area/ruin/powered)
"bU" = (/obj/structure/closet/crate/critter,/turf/open/floor/plasteel/blue/side{baseturf = /turf/open/floor/plating/lava/smooth/lava_land_surface; dir = 8},/area/ruin/powered)
"bV" = (/turf/open/floor/plasteel/blue/side{baseturf = /turf/open/floor/plating/lava/smooth/lava_land_surface; dir = 10},/area/ruin/powered)
"bW" = (/obj/structure/chair/comfy/teal{dir = 8},/turf/open/floor/plasteel/blue/side{baseturf = /turf/open/floor/plating/lava/smooth/lava_land_surface; dir = 6},/area/ruin/powered)
"bX" = (/obj/structure/table,/obj/item/weapon/tank/internals/oxygen,/obj/item/weapon/tank/internals/oxygen,/turf/open/floor/plasteel/blue/side{baseturf = /turf/open/floor/plating/lava/smooth/lava_land_surface; dir = 8},/area/ruin/powered)
"bY" = (/obj/structure/sign/bluecross_2{name = "animal hospital"},/turf/closed/wall/shuttle/smooth{baseturf = /turf/open/floor/plating/lava/smooth/lava_land_surface},/area/ruin/powered)
"bZ" = (/obj/machinery/door/airlock/glass_large{name = "Ian's Pet Care"},/turf/open/floor/plasteel{baseturf = /turf/open/floor/plating/lava/smooth/lava_land_surface},/area/ruin/powered)
"ca" = (/obj/item/weapon/reagent_containers/glass/bowl,/obj/item/weapon/reagent_containers/food/snacks/grown/wheat,/obj/item/weapon/reagent_containers/food/snacks/grown/wheat,/obj/item/weapon/reagent_containers/food/snacks/grown/wheat,/obj/effect/decal/cleanable/dirt,/turf/open/floor/plasteel/white{baseturf = /turf/open/floor/plating/lava/smooth/lava_land_surface},/area/ruin/powered)
"cb" = (/obj/vehicle/scooter/skateboard{dir = 4},/turf/open/floor/grass{baseturf = /turf/open/floor/plating/lava/smooth/lava_land_surface; initial_gas_mix = "o2=14;n2=23;TEMP=300"},/area/lavaland/surface/outdoors)
"cc" = (/obj/structure/flora/ausbushes/sunnybush,/turf/open/floor/grass{baseturf = /turf/open/floor/plating/lava/smooth/lava_land_surface; initial_gas_mix = "o2=14;n2=23;TEMP=300"},/area/lavaland/surface/outdoors)
"cd" = (/obj/effect/mob_spawn/cow{dir = 4; flavour_text = "<font size=3><b>Y</b></font><b>ou're a cow. You've lived a pampered life as a prized show heifer, a real blue-ribbon winner. After showing signs of a minor respiratory infection, your master took you to the hospital right away. He'd better come back soon. You're getting quite impatient.</b>"; mob_name = "Flossie"},/turf/open/floor/plasteel/white{baseturf = /turf/open/floor/plating/lava/smooth/lava_land_surface},/area/ruin/powered)
"ce" = (/obj/structure/flora/ausbushes/ppflowers,/turf/open/floor/grass{baseturf = /turf/open/floor/plating/lava/smooth/lava_land_surface; initial_gas_mix = "o2=14;n2=23;TEMP=300"},/area/lavaland/surface/outdoors)
"cf" = (/obj/structure/chair/office/light{dir = 4},/obj/effect/decal/cleanable/dirt,/turf/open/floor/plasteel/white{baseturf = /turf/open/floor/plating/lava/smooth/lava_land_surface},/area/ruin/powered)
"cg" = (/obj/structure/table/glass,/obj/item/clothing/tie/petcollar,/obj/item/weapon/pen/blue,/turf/open/floor/plasteel/white{baseturf = /turf/open/floor/plating/lava/smooth/lava_land_surface},/area/ruin/powered)
"ch" = (/obj/structure/table,/obj/machinery/cell_charger,/obj/item/weapon/melee/baton/cattleprod{desc = "On-the-fly rabies treatment."; name = "cattle prod"},/obj/item/weapon/stock_parts/cell/high,/turf/open/floor/plasteel/blue/side{baseturf = /turf/open/floor/plating/lava/smooth/lava_land_surface; dir = 10},/area/ruin/powered)
"ci" = (/obj/structure/closet,/obj/item/weapon/defibrillator/loaded,/obj/item/weapon/storage/belt/medical,/obj/item/clothing/glasses/hud/health,/turf/open/floor/plasteel/blue/side{baseturf = /turf/open/floor/plating/lava/smooth/lava_land_surface; dir = 6},/area/ruin/powered)
"cj" = (/obj/item/weapon/pickaxe,/obj/effect/decal/cleanable/blood/old,/turf/open/floor/plating/asteroid/basalt/lava_land_surface,/area/lavaland/surface/outdoors)
"ck" = (/obj/effect/decal/remains/human,/turf/open/floor/plating/asteroid/basalt/lava_land_surface,/area/lavaland/surface/outdoors)
"cl" = (/obj/effect/decal/cleanable/blood/old,/turf/open/floor/plating/asteroid/basalt/lava_land_surface,/area/lavaland/surface/outdoors)
"cm" = (/turf/open/floor/grass,/area/lavaland/surface/outdoors)

(1,1,1) = {"
aaaaaaaaaaaaaaaaabababababababaaaaaaaaaaaa
aaaaaaaaaaaaababababacacabacabababaaaaaaaa
aaaaaaaaaaaaababacabacacacadaeafabababaaaa
aaaaaaaaaaababacacacacagacahahaiacacababaa
aaaaaaaaajajajajajakakakajajajalajajajajaa
aaaaababajamanajaoapaqarasajatauavawaxajaa
aaaaababajamamajayazayaAayajaBaCaCaCaDajaa
aaababaEajaFamajayayaGayayajaHaCaIaJaKajaa
abababacaLajaMaNaOajajajaOaPajaQaRaRaRajaa
ababaSaSaTaUaUaVaUaWaWaWaUaVaVaUaVaXaYajaa
abababacajaUaUaZaZaUaZaUaZaZaZaUaZbabbajaa
aaababajaLbcaLajajbdajbeajajaLbfajbgbbajaa
ababacajbhbiajbjbkaCajaCbkblajbmajbgbbajaa
aaababajbnboajbpaCbqajbraCbsajbtajbgbbajaa
aaaaaaajbubvajbwbxaCajaCaCbyajbzajbgbbajaa
aaaaaaajaLbcaLaNajbdajbeajajajajaLbgbbajaa
aaaaaaaaajaUaVaVaVaUbAaUbBajbCbDakbEbbajaa
aaaaaaaaajbFbGbHbIaUbJaUbKajbLbMbNaUbbajaa
aaaaaaaaajbObPbQbRaUaUaUbKajbSbTajbUbbajaa
aaaaaaaaajbVaZaZaZaUaUaZbWajajajaLbXbbajaa
aaaaaaabajajakakbYbZaUajajajbCcaakbgbbajaa
aaaaababacacagcbccaSaSccacajcdaCbNaUbbajaa
aaaaabababacacacacaSaSacceajcfcgajchciajaa
aaababcjababacacabaSabacacajajajajajajajaa
aaabckababababacababababababababaaaaaaaaaa
aaabclabababababababcmababababaaaaaaaaaaaa
aaaaababababcmababababababaaaaaaaaaaaaaaaa
aaaaababababcmababababababaaaaaaaaaaaaaaaa
"}
