"aa" = (/turf/template_noop,/area/template_noop)
"ab" = (/turf/open/floor/plating/asteroid/basalt/lava_land_surface,/area/ruin/powered)
"ac" = (/turf/open/floor/noslip{baseturf = /turf/open/floor/plating/lava/smooth},/area/ruin/powered)
"ad" = (/mob/living/simple_animal/hostile/retaliate/clown,/turf/open/floor/plating/asteroid/basalt/lava_land_surface,/area/ruin/powered)
"ae" = (/obj/machinery/light,/turf/open/floor/plating/asteroid/basalt/lava_land_surface,/area/ruin/powered)
"af" = (/obj/item/clothing/head/cone,/turf/open/floor/noslip{baseturf = /turf/open/floor/plating/lava/smooth},/area/ruin/powered)
"ag" = (/obj/item/weapon/paper/crumpled/bloody{info = "Abandon hope, all ye who enter here."},/obj/effect/decal/cleanable/blood/old,/turf/open/floor/noslip{baseturf = /turf/open/floor/plating/lava/smooth},/area/ruin/powered)
"ah" = (/turf/closed/wall/r_wall{baseturf = /turf/open/floor/plating/lava/smooth},/area/ruin/powered)
"ai" = (/obj/machinery/disposal/deliveryChute{desc = "The following is engraved upon the chute: A FATE WORSE THAN DEATH LIES WITHIN"; dir = 1; name = "THE TRIAL OF HONKITUDE"},/obj/structure/disposalpipe/trunk,/turf/open/floor/noslip{baseturf = /turf/open/floor/plating/lava/smooth},/area/ruin/powered)
"aj" = (/obj/structure/disposalpipe/trunk,/obj/structure/disposaloutlet{dir = 1},/turf/open/floor/noslip{baseturf = /turf/open/floor/plating/lava/smooth},/area/ruin/powered)
"ak" = (/turf/open/floor/plating/lava/smooth/lava_land_surface,/area/ruin/powered)
"al" = (/obj/structure/disposalpipe/segment{invisibility = 101},/turf/closed/wall/r_wall{baseturf = /turf/open/floor/plating/lava/smooth},/area/ruin/powered)
"am" = (/obj/structure/disposalpipe/segment{dir = 4; icon_state = "pipe-c"; invisibility = 101},/turf/closed/wall/r_wall{baseturf = /turf/open/floor/plating/lava/smooth},/area/ruin/powered)
"an" = (/obj/structure/disposalpipe/segment{dir = 2; icon_state = "pipe-c"; invisibility = 101},/turf/closed/wall/r_wall{baseturf = /turf/open/floor/plating/lava/smooth},/area/ruin/powered)
"ao" = (/obj/structure/disposalpipe/trunk,/obj/structure/disposaloutlet{dir = 1},/turf/closed/wall/r_wall{baseturf = /turf/open/floor/plating/lava/smooth},/area/ruin/powered)
"ap" = (/obj/structure/disposalpipe/segment{invisibility = 101},/turf/open/indestructible{icon_state = "darkyellowfull"; wet = 5},/area/ruin/powered)
"aq" = (/obj/effect/mob_spawn/human/corpse/damaged,/obj/effect/decal/cleanable/blood/old,/obj/structure/disposalpipe/segment{invisibility = 101},/turf/open/indestructible{icon_state = "darkyellowfull"; wet = 5},/area/ruin/powered)
"ar" = (/obj/structure/disposalpipe/segment{dir = 4; icon_state = "pipe-c"; invisibility = 101},/turf/open/indestructible{icon_state = "darkyellowfull"; wet = 5},/area/ruin/powered)
"as" = (/obj/structure/disposalpipe/sortjunction{dir = 1; icon_state = "pipe-j2s"; invisibility = 101; sortType = 3},/turf/closed/wall/r_wall{baseturf = /turf/open/floor/plating/lava/smooth},/area/ruin/powered)
"at" = (/obj/effect/decal/cleanable/pie_smudge,/obj/structure/disposalpipe/segment{invisibility = 101},/turf/open/indestructible{icon_state = "darkyellowfull"; wet = 5},/area/ruin/powered)
"au" = (/obj/structure/disposalpipe/segment{dir = 1; icon_state = "pipe-c"; invisibility = 101},/obj/effect/decal/cleanable/dirt,/turf/open/indestructible{icon_state = "darkyellowfull"; wet = 5},/area/ruin/powered)
"av" = (/obj/structure/disposalpipe/segment{dir = 4; invisibility = 101},/obj/effect/decal/cleanable/dirt,/turf/open/indestructible{icon_state = "darkyellowfull"; wet = 5},/area/ruin/powered)
"aw" = (/obj/structure/disposalpipe/segment{dir = 4; invisibility = 101},/turf/open/indestructible{icon_state = "darkyellowfull"; wet = 5},/area/ruin/powered)
"ax" = (/obj/structure/disposalpipe/segment{dir = 8; icon_state = "pipe-c"; invisibility = 101},/turf/open/indestructible{icon_state = "darkyellowfull"; wet = 5},/area/ruin/powered)
"ay" = (/turf/open/indestructible{icon_state = "darkyellowfull"; wet = 5},/area/ruin/powered)
"az" = (/obj/effect/decal/cleanable/dirt,/turf/open/indestructible{icon_state = "darkyellowfull"; wet = 5},/area/ruin/powered)
"aA" = (/obj/effect/decal/cleanable/cobweb{icon_state = "cobweb2"},/turf/open/indestructible{icon_state = "darkyellowfull"; wet = 5},/area/ruin/powered)
"aB" = (/obj/structure/disposalpipe/segment{dir = 4; invisibility = 101},/obj/effect/decal/cleanable/cobweb,/turf/open/indestructible{icon_state = "darkyellowfull"; wet = 5},/area/ruin/powered)
"aC" = (/obj/structure/disposalpipe/segment{dir = 1; icon_state = "pipe-c"; invisibility = 101},/turf/open/indestructible{icon_state = "darkyellowfull"; wet = 5},/area/ruin/powered)
"aD" = (/obj/structure/disposalpipe/segment{dir = 8; icon_state = "pipe-c"; invisibility = 101},/obj/effect/decal/cleanable/dirt,/turf/open/indestructible{icon_state = "darkyellowfull"; wet = 5},/area/ruin/powered)
"aE" = (/obj/structure/disposalpipe/segment{dir = 1; icon_state = "pipe-c"; invisibility = 101},/obj/item/weapon/bikehorn,/turf/open/indestructible{icon_state = "darkyellowfull"; wet = 5},/area/ruin/powered)
"aF" = (/obj/structure/disposalpipe/segment{dir = 1; icon_state = "pipe-c"; invisibility = 101},/turf/closed/wall/r_wall{baseturf = /turf/open/floor/plating/lava/smooth},/area/ruin/powered)
"aG" = (/obj/structure/disposalpipe/segment{dir = 4; invisibility = 101},/obj/effect/decal/cleanable/pie_smudge,/turf/open/indestructible{icon_state = "darkyellowfull"; wet = 5},/area/ruin/powered)
"aH" = (/obj/structure/disposalpipe/segment{dir = 4; invisibility = 101},/turf/closed/wall/r_wall{baseturf = /turf/open/floor/plating/lava/smooth},/area/ruin/powered)
"aI" = (/obj/structure/disposalpipe/segment{dir = 2; icon_state = "pipe-c"; invisibility = 101},/turf/open/indestructible{icon_state = "darkyellowfull"; wet = 5},/area/ruin/powered)
"aJ" = (/obj/item/weapon/bikehorn,/obj/structure/disposalpipe/segment{dir = 4; invisibility = 101},/turf/open/indestructible{icon_state = "darkyellowfull"; wet = 5},/area/ruin/powered)
"aK" = (/obj/structure/disposalpipe/segment{dir = 4; invisibility = 101},/turf/open/floor/plating{baseturf = /turf/open/floor/plating/lava/smooth},/area/ruin/powered)
"aL" = (/obj/structure/disposalpipe/segment{dir = 8; icon_state = "pipe-c"; invisibility = 101},/turf/closed/wall/r_wall{baseturf = /turf/open/floor/plating/lava/smooth},/area/ruin/powered)
"aM" = (/obj/effect/decal/cleanable/dirt,/obj/structure/disposalpipe/segment{invisibility = 101},/turf/open/indestructible{icon_state = "darkyellowfull"; wet = 5},/area/ruin/powered)
"aN" = (/obj/structure/grille,/obj/structure/window/reinforced/fulltile,/turf/open/floor/plating{baseturf = /turf/open/floor/plating/lava/smooth},/area/ruin/powered)
"aO" = (/obj/structure/disposalpipe/segment{dir = 2; icon_state = "pipe-c"; invisibility = 101},/obj/effect/decal/cleanable/dirt,/turf/open/indestructible{icon_state = "darkyellowfull"; wet = 5},/area/ruin/powered)
"aP" = (/obj/item/weapon/bikehorn,/obj/effect/decal/cleanable/dirt,/obj/structure/disposalpipe/segment{invisibility = 101},/turf/open/indestructible{icon_state = "darkyellowfull"; wet = 5},/area/ruin/powered)
"aQ" = (/obj/structure/disposalpipe/trunk{dir = 4},/obj/structure/disposaloutlet{dir = 8},/turf/open/floor/plating{baseturf = /turf/open/floor/plating/lava/smooth},/area/ruin/powered)
"aR" = (/obj/item/weapon/bikehorn,/obj/structure/disposalpipe/segment{invisibility = 101},/turf/open/indestructible{icon_state = "darkyellowfull"; wet = 5},/area/ruin/powered)
"aS" = (/obj/structure/disposalpipe/segment{dir = 4; invisibility = 101},/turf/open/indestructible{icon_state = "darkredfull"},/area/ruin/powered)
"aT" = (/obj/effect/decal/cleanable/pie_smudge,/turf/open/indestructible{icon_state = "darkyellowfull"; wet = 5},/area/ruin/powered)
"aU" = (/obj/structure/disposalpipe/segment{dir = 4; invisibility = 101},/turf/open/indestructible{icon_state = "white"},/area/ruin/powered)
"aV" = (/obj/structure/disposalpipe/segment{dir = 4; icon_state = "pipe-c"; invisibility = 101},/obj/effect/decal/cleanable/dirt,/turf/open/indestructible{icon_state = "darkyellowfull"; wet = 5},/area/ruin/powered)
"aW" = (/obj/structure/disposalpipe/segment{dir = 4; invisibility = 101},/obj/structure/table,/obj/item/weapon/paper/crumpled/bloody{info = "If you dare not continue down this path of madness, escape can be found through the chute in this room. "},/obj/item/weapon/pen/fourcolor,/turf/open/indestructible{icon_state = "white"},/area/ruin/powered)
"aX" = (/obj/structure/disposalpipe/segment{dir = 4; invisibility = 101},/obj/structure/table,/obj/item/device/flashlight/lamp/bananalamp,/turf/open/indestructible{icon_state = "white"},/area/ruin/powered)
"aY" = (/obj/structure/disposalpipe/segment{dir = 2; icon_state = "pipe-c"; invisibility = 101},/obj/effect/decal/cleanable/pie_smudge,/turf/open/indestructible{icon_state = "darkyellowfull"; wet = 5},/area/ruin/powered)
"aZ" = (/obj/structure/disposalpipe/segment{dir = 4; invisibility = 101},/obj/item/weapon/pickaxe,/turf/open/indestructible{icon_state = "white"},/area/ruin/powered)
"ba" = (/obj/structure/disposalpipe/segment{dir = 4; icon_state = "pipe-c"; invisibility = 101},/turf/open/indestructible{icon_state = "white"},/area/ruin/powered)
"bb" = (/obj/structure/disposalpipe/segment{dir = 2; icon_state = "pipe-c"; invisibility = 101},/turf/open/indestructible{icon_state = "white"},/area/ruin/powered)
"bc" = (/obj/structure/disposalpipe/segment{dir = 4; invisibility = 101},/turf/open/indestructible{icon_state = "light_on"},/area/ruin/powered)
"bd" = (/obj/structure/disposalpipe/segment{invisibility = 101},/turf/open/floor/plating{baseturf = /turf/open/floor/plating/lava/smooth},/area/ruin/powered)
"be" = (/obj/structure/disposalpipe/segment{invisibility = 101},/turf/open/indestructible{icon_state = "white"},/area/ruin/powered)
"bf" = (/turf/open/indestructible{icon_state = "light_on"},/area/ruin/powered)
"bg" = (/obj/structure/disposalpipe/segment{dir = 1; icon_state = "pipe-c"; invisibility = 101},/turf/open/indestructible{icon_state = "white"},/area/ruin/powered)
"bh" = (/obj/structure/disposalpipe/segment{dir = 8; icon_state = "pipe-c"; invisibility = 101},/turf/open/indestructible{icon_state = "white"},/area/ruin/powered)
"bi" = (/obj/machinery/light{icon_state = "tube1"; dir = 4},/turf/open/floor/plating/asteroid/basalt/lava_land_surface,/area/ruin/powered)
"bj" = (/turf/closed/mineral/clown,/area/ruin/powered)
"bk" = (/obj/item/weapon/pickaxe,/turf/open/indestructible{icon_state = "white"},/area/ruin/powered)
"bl" = (/turf/open/indestructible{icon_state = "white"},/area/ruin/powered)
"bm" = (/obj/structure/disposalpipe/segment{dir = 4; icon_state = "pipe-c"; invisibility = 101},/turf/open/indestructible{icon_state = "darkredfull"},/area/ruin/powered)
"bn" = (/obj/structure/disposalpipe/segment{dir = 1; icon_state = "pipe-c"; invisibility = 101},/turf/open/floor/plating{baseturf = /turf/open/floor/plating/lava/smooth},/area/ruin/powered)
"bo" = (/obj/item/weapon/bikehorn,/obj/structure/disposalpipe/segment{dir = 2; icon_state = "pipe-c"; invisibility = 101},/turf/open/indestructible{icon_state = "darkyellowfull"; wet = 5},/area/ruin/powered)
"bp" = (/obj/machinery/light{dir = 8},/turf/open/floor/plating/asteroid/basalt/lava_land_surface,/area/ruin/powered)
"bq" = (/turf/open/chasm/straight_down/lava_land_surface,/area/ruin/powered)
"br" = (/obj/effect/decal/cleanable/cobweb,/turf/open/indestructible{icon_state = "darkredfull"; wet = 5},/area/ruin/powered)
"bs" = (/obj/structure/disposalpipe/segment,/turf/open/indestructible{icon_state = "darkyellowfull"; wet = 5},/area/ruin/powered)
"bt" = (/obj/machinery/disposal/deliveryChute{dir = 1},/obj/structure/disposalpipe/trunk,/turf/open/indestructible{icon_state = "white"},/area/ruin/powered)
"bu" = (/turf/open/indestructible{icon_state = "darkredfull"; wet = 5},/area/ruin/powered)
"bv" = (/turf/open/indestructible/sound{icon_state = "bananium"; name = "bananium floor"; sound = 'sound/effects/clownstep1.ogg'; wet = 5},/area/ruin/powered)
"bw" = (/obj/structure/disposalpipe/junction{dir = 1; icon_state = "pipe-y"; invisibility = 101},/obj/effect/decal/cleanable/dirt,/turf/open/indestructible{icon_state = "darkyellowfull"; wet = 5},/area/ruin/powered)
"bx" = (/obj/structure/mecha_wreckage/honker,/obj/structure/disposalpipe/segment{dir = 4; invisibility = 101},/turf/open/floor/plating{baseturf = /turf/open/floor/plating/lava/smooth},/area/ruin/powered)
"by" = (/obj/effect/decal/cleanable/oil,/obj/structure/disposalpipe/segment{dir = 2; icon_state = "pipe-c"; invisibility = 101},/turf/open/floor/plating{baseturf = /turf/open/floor/plating/lava/smooth},/area/ruin/powered)
"bz" = (/obj/effect/decal/cleanable/cobweb{icon_state = "cobweb2"},/turf/open/indestructible/sound{icon_state = "bananium"; name = "bananium floor"; sound = 'sound/effects/clownstep1.ogg'; wet = 5},/area/ruin/powered)
"bA" = (/obj/item/weapon/grown/bananapeel{color = "#2F3000"; name = "stealth banana peel"},/turf/open/floor/plating/asteroid/basalt/lava_land_surface,/area/ruin/powered)
"bB" = (/obj/effect/decal/cleanable/dirt,/turf/open/indestructible/sound{icon_state = "bananium"; name = "bananium floor"; sound = 'sound/effects/clownstep1.ogg'; wet = 5},/area/ruin/powered)
"bC" = (/obj/effect/mob_spawn/human/corpse/damaged,/obj/effect/decal/cleanable/blood/old,/turf/open/indestructible{icon_state = "darkyellowfull"; wet = 5},/area/ruin/powered)
"bD" = (/obj/structure/disposalpipe/segment{dir = 4; invisibility = 101},/turf/open/indestructible{icon_state = "darkredfull"; wet = 5},/area/ruin/powered)
"bE" = (/obj/structure/disposalpipe/segment{dir = 8; icon_state = "pipe-c"; invisibility = 101},/turf/open/indestructible{icon_state = "darkredfull"; wet = 5},/area/ruin/powered)
"bF" = (/turf/open/floor/plating/lava/smooth/lava_land_surface{initial_gas_mix = "o2=22;n2=82;TEMP=293.15"},/area/ruin/powered)
"bG" = (/obj/item/weapon/reagent_containers/food/drinks/trophy/gold_cup,/obj/structure/table/glass,/turf/open/floor/carpet{baseturf = /turf/open/floor/plating/lava/smooth},/area/ruin/powered)
"bH" = (/turf/open/floor/carpet{baseturf = /turf/open/floor/plating/lava/smooth},/area/ruin/powered)
"bI" = (/obj/machinery/disposal/deliveryChute,/obj/structure/disposalpipe/trunk{dir = 1},/turf/open/floor/carpet{baseturf = /turf/open/floor/plating/lava/smooth},/area/ruin/powered)
"bJ" = (/obj/effect/decal/cleanable/cobweb,/turf/open/floor/plating/lava/smooth/lava_land_surface{initial_gas_mix = "o2=22;n2=82;TEMP=293.15"},/area/ruin/powered)
"bK" = (/obj/structure/statue/bananium/clown,/turf/open/floor/carpet{baseturf = /turf/open/floor/plating/lava/smooth},/area/ruin/powered)
"bL" = (/obj/structure/table/glass,/obj/item/weapon/grown/bananapeel/bluespace,/turf/open/floor/carpet{baseturf = /turf/open/floor/plating/lava/smooth},/area/ruin/powered)
"bM" = (/obj/structure/table/glass,/obj/item/clothing/shoes/clown_shoes/banana_shoes,/turf/open/floor/carpet{baseturf = /turf/open/floor/plating/lava/smooth},/area/ruin/powered)
"bN" = (/obj/structure/grille,/obj/structure/window/reinforced/fulltile,/turf/open/floor/plating,/area/ruin/powered)
"bO" = (/obj/effect/decal/cleanable/dirt,/turf/open/floor/plating/lava/smooth/lava_land_surface{initial_gas_mix = "o2=22;n2=82;TEMP=293.15"},/area/ruin/powered)
"bP" = (/obj/item/weapon/coin/clown,/obj/item/weapon/coin/clown,/obj/item/weapon/coin/clown,/obj/item/weapon/coin/clown,/turf/open/floor/carpet{baseturf = /turf/open/floor/plating/lava/smooth},/area/ruin/powered)
"bQ" = (/obj/item/slime_extract/rainbow,/obj/structure/table/glass,/turf/open/floor/carpet{baseturf = /turf/open/floor/plating/lava/smooth},/area/ruin/powered)
"bR" = (/obj/item/weapon/bikehorn/airhorn,/turf/open/floor/carpet{baseturf = /turf/open/floor/plating/lava/smooth},/area/ruin/powered)
"bS" = (/obj/structure/table/glass,/obj/item/weapon/gun/magic/staff/honk,/turf/open/floor/carpet{baseturf = /turf/open/floor/plating/lava/smooth},/area/ruin/powered)
"bT" = (/obj/item/weapon/bikehorn,/turf/open/indestructible/sound{icon_state = "bananium"; name = "bananium floor"; sound = 'sound/effects/clownstep1.ogg'; wet = 5},/area/ruin/powered)
"bU" = (/obj/effect/mob_spawn/human/corpse/damaged,/obj/effect/decal/cleanable/blood/old,/turf/open/floor/plating/lava/smooth/lava_land_surface{initial_gas_mix = "o2=22;n2=82;TEMP=293.15"},/area/ruin/powered)
"bV" = (/obj/effect/mob_spawn/human/corpse/damaged,/obj/effect/decal/cleanable/blood/old,/turf/open/indestructible/sound{icon_state = "bananium"; name = "bananium floor"; sound = 'sound/effects/clownstep1.ogg'; wet = 5},/area/ruin/powered)
"bW" = (/obj/machinery/door/airlock/clown,/turf/open/indestructible/sound{icon_state = "bananium"; name = "bananium floor"; sound = 'sound/effects/clownstep1.ogg'; wet = 5},/area/ruin/powered)
"bX" = (/obj/item/weapon/bikehorn,/obj/effect/decal/cleanable/dirt,/turf/open/indestructible/sound{icon_state = "bananium"; name = "bananium floor"; sound = 'sound/effects/clownstep1.ogg'; wet = 5},/area/ruin/powered)
"bY" = (/obj/machinery/light{dir = 1},/turf/open/floor/plating/asteroid/basalt/lava_land_surface,/area/ruin/powered)

(1,1,1) = {"
aaaaaaaaaaaaaaaaaaaaaaaaababacacacababaaaaaaaaaaaaaaaaaaaaaaaaaa
aaaaaaaaaaaaaaaaaaadaeadadafacagacacadadaeadaaaaaaaaaaaaaaaaaaaa
aaaaaaaaaaaaahahahahahahahahaiacajahahahahahahahahahaaaaaaaaaaaa
aaaaaaaaahahahakakakakakakahalahalahakakakakakakakahahaaaaaaaaaa
aaaaaaahahakakakamanamanahakalakalakakahahaoahahakakahahaaaaaaaa
aaaaahahakakamanapaqalaparanalamasahahahahalahahahahakahahaaaaaa
aaaaahakakahatapapapapapapapapapauavavawawaxayazaAahakakahaaaaaa
aaahahakamaBaxaCaDaCaDaEaxapalaFawavavawaGaHawawawaIahakahahaaaa
aaahakakalaravavawaHavavaIapaparawavaJawaHaKawaHawaxahakakahaaaa
aaahakamaLapamaHawavavanatapaMaCaHawawavavavaJawawaIahaNakahaaaa
aaahakaFaOaPapaQaHaHaHaxapaRalarawawawawaHaHaSaHaIapaTaNakahaaaa
aaahakamaDapaFaHaUaUaUaHaxapatapaVawaHaHaWaXaUaHaxapayaNakahaaaa
aaahakaFaYaCaHaUaUaUaZaUaHaDapapapayahbaaUaUbbbaaHaLahahakahaaaa
aaahahakaFaHaHaUaUbcbcaUaHawaDbdaCaIahbebfbfbgbhahahahakahahaaaa
aabiahahakakahbjbkbfbfblbmaOazbnboaCaSbhbfbfblbjahakakahahbpaaaa
ababbqahahahbrahbjblbjahalauawaIbsaTahahbjbtbjahbuahahahbqababaa
abbqbqbqahbvbubuahbjahahaFavaIaCbwaHbxbyahalahbububzahbqbqabbqaa
ababbAbqahbBbvbububububuahahaCaOazbCahaFbDbEbububvbvahbqbAababaa
ababbqbqahbvbBbvbubububvahahahalahahbvbvbuahbubvbvbvahbqbqababaa
abbqbqahahbFbBbvbvbvbvbvahbGbHbIbHbGahbvbvbvbvbvbvahahahbqbqabaa
aabiahahbJbFbvbvbvbvbvahbKbHbLbHbMbHbKahbvbvbvbvbBbFbFahahbpaaaa
aaahahbNbFbObBbBbBbvbvahbPbHbQbRbSbHbPahbvbBbBbvbTbFbFbNahahaaaa
aaahakakbNbUbFbvbvbvbvbvahbHbHbHbHbHahbVbvbBbBbvbvbFbFbNakahaaaa
aaahakakbNbFbFbvbvbBbvbvbvahahbWahahbvbvbBbBbvbvbvbFbFbNakahaaaa
aaahakakakbNbFbFbXbBbvbBbvbvbBbvbvbvbvbvbvbvbvbvbFbFbFbNakahaaaa
aaahahakakakahbFbObvbvbvbBbBbBbBbvbvbBbBbvbTbvbFbFbFbNakahahaaaa
aaaaahakakakakbNbFbFbObBbXbBbvbvbvbvbBbFbFbFbFbFbFbNakakahaaaaaa
aaaaahahakakakakahbFbFbFbFbFbFbFbFbFbFbFbFbFbFbNbNakakahahaaaaaa
aaaaaaahahakakakakbNbNbFbFbFbFbFbFbFbFbNbNbNbNakakakahahaaaaaaaa
aaaaaaaaahahahakakakakbNbNbNbNbNbNbNbNbNakakakakahahahaaaaaaaaaa
aaaaaaaaaabYahahahahakakakakakakakakakakakahahahahbYaaaaaaaaaaaa
aaaaaaaaaaaaaaaaaaahahahahahahahahahahahahahaaaaaaaaaaaaaaaaaaaa
"}
