//MAP CONVERTED BY dmm2tgm.py THIS HEADER COMMENT PREVENTS RECONVERSION, DO NOT REMOVE
"a" = (
/turf/open/floor/plating/asteroid/basalt/lava_land_surface,
/area/lavaland/surface/outdoors)
"b" = (
/turf/closed/wall/mineral/diamond,
/area/ruin/lavaland/powered/pride)
"c" = (
/turf/open/lava/smooth/lava_land_surface,
/area/lavaland/surface/outdoors)
"e" = (
/obj/structure/mirror{
	pixel_x = -32
	},
/turf/open/floor/mineral/silver,
/area/ruin/lavaland/powered/pride)
"f" = (
/obj/structure/mirror{
	pixel_x = 32
	},
/turf/open/floor/mineral/silver,
/area/ruin/lavaland/powered/pride)
"g" = (
/turf/open/floor/mineral/silver,
/area/ruin/lavaland/powered/pride)
"i" = (
/obj/item/clothing/gloves/ring,
/turf/open/floor/mineral/silver,
/area/ruin/lavaland/powered/pride)
"j" = (
/obj/structure/mirror{
	pixel_x = -32
	},
/obj/machinery/light/small{
	dir = 1
	},
/turf/open/floor/mineral/silver,
/area/ruin/lavaland/powered/pride)
"k" = (
/obj/structure/mirror/magic/pride,
/turf/closed/wall/mineral/diamond,
/area/ruin/lavaland/powered/pride)
"l" = (
/obj/structure/mirror{
	pixel_x = -32
	},
/obj/machinery/light/small{
	brightness = 3;
	dir = 8
	},
/turf/open/floor/mineral/silver,
/area/ruin/lavaland/powered/pride)
"m" = (
/obj/structure/mirror{
	pixel_x = 32
	},
/obj/machinery/light/small{
	dir = 4
	},
/turf/open/floor/mineral/silver,
/area/ruin/lavaland/powered/pride)
"o" = (
/obj/structure/mirror{
	pixel_x = -32
	},
/obj/item/lipstick/random,
/turf/open/floor/mineral/silver,
/area/ruin/lavaland/powered/pride)
"q" = (
/obj/structure/mirror{
	pixel_x = -32
	},
/obj/item/clothing/gloves/ring/silver,
/turf/open/floor/mineral/silver,
/area/ruin/lavaland/powered/pride)
"r" = (
/obj/machinery/light/small,
/turf/open/floor/mineral/silver,
/area/ruin/lavaland/powered/pride)
"u" = (
/obj/structure/mirror{
	pixel_x = 32
	},
/obj/item/lipstick/random,
/turf/open/floor/mineral/silver,
/area/ruin/lavaland/powered/pride)
"D" = (
/obj/item/clothing/head/wig/random,
/turf/open/floor/mineral/silver,
/area/ruin/lavaland/powered/pride)
"G" = (
/turf/closed/mineral/volcanic/lava_land_surface,
/area/lavaland/surface/outdoors)
"I" = (
/obj/item/clothing/gloves/ring/silver,
/turf/open/floor/mineral/silver,
/area/ruin/lavaland/powered/pride)
"J" = (
/obj/structure/mirror{
	pixel_x = 32
	},
/obj/machinery/light/small{
	dir = 1
	},
/turf/open/floor/mineral/silver,
/area/ruin/lavaland/powered/pride)
"L" = (
/obj/item/lipstick/random,
/turf/open/floor/mineral/silver,
/area/ruin/lavaland/powered/pride)
"O" = (
/obj/item/clothing/gloves/ring/diamond,
/turf/open/floor/mineral/silver,
/area/ruin/lavaland/powered/pride)
"V" = (
/obj/item/clothing/head/wig,
/turf/open/floor/mineral/silver,
/area/ruin/lavaland/powered/pride)
"Y" = (
/obj/machinery/door/airlock/silver/glass,
/turf/open/floor/mineral/silver{
	blocks_air = 1
	},
/area/ruin/lavaland/powered/pride)

(1,1,1) = {"
a
a
a
a
a
a
a
a
a
a
a
a
a
a
a
a
"}
(2,1,1) = {"
a
a
c
c
c
c
c
c
c
c
c
c
c
c
c
a
"}
(3,1,1) = {"
G
c
c
b
b
b
b
b
b
b
b
b
b
b
c
a
"}
(4,1,1) = {"
c
c
b
b
j
q
e
l
e
e
l
e
o
b
c
a
"}
(5,1,1) = {"
c
b
b
g
g
g
L
g
V
g
L
i
r
b
a
a
"}
(6,1,1) = {"
c
b
O
g
k
g
g
I
g
g
g
g
g
Y
a
a
"}
(7,1,1) = {"
c
b
b
g
g
L
D
g
L
i
g
D
r
b
a
a
"}
(8,1,1) = {"
c
c
b
b
J
f
f
m
f
f
m
u
f
b
c
a
"}
(9,1,1) = {"
G
c
c
b
b
b
b
b
b
b
b
b
b
b
c
a
"}
(10,1,1) = {"
G
G
c
c
c
c
c
c
c
c
c
c
c
c
c
a
"}
