//MAP CONVERTED BY dmm2tgm.py THIS HEADER COMMENT PREVENTS RECONVERSION, DO NOT REMOVE
"b" = (
/turf/closed/wall/mineral/wood/nonmetal,
/area/ruin/lavaland/unpowered)
"c" = (
/obj/structure/closet/toolcloset,
/obj/item/wrench,
/obj/item/screwdriver,
/obj/item/crowbar,
/obj/item/weldingtool/largetank,
/obj/item/wirecutters,
/obj/item/radio/off,
/turf/open/floor/wood,
/area/ruin/lavaland/unpowered)
"d" = (
/turf/open/openspace/icemoon,
/area/template_noop)
"e" = (
/obj/item/clothing/suit/hooded/explorer,
/obj/item/clothing/mask/gas/explorer,
/obj/item/clothing/gloves/color/black,
/obj/item/storage/backpack/explorer,
/obj/item/flashlight/lantern,
/obj/item/storage/bag/ore,
/obj/structure/closet,
/obj/item/clothing/shoes/jackboots,
/turf/open/floor/wood,
/area/ruin/lavaland/unpowered)
"f" = (
/turf/open/floor/wood,
/area/ruin/lavaland/unpowered)
"g" = (
/obj/structure/fireplace,
/turf/open/floor/wood,
/area/ruin/lavaland/unpowered)
"h" = (
/obj/structure/flora/ash/cacti,
/turf/open/floor/plating/asteroid/basalt/lava_land_surface,
/area/lavaland/surface/outdoors)
"i" = (
/turf/template_noop,
/area/template_noop)
"j" = (
/obj/structure/sink/kitchen,
/turf/open/floor/wood,
/area/ruin/lavaland/unpowered)
"k" = (
/obj/structure/closet/crate/freezer,
/turf/open/floor/wood,
/area/ruin/lavaland/unpowered)
"l" = (
/obj/machinery/vending/dinnerware,
/turf/open/floor/wood,
/area/ruin/lavaland/unpowered)
"m" = (
/obj/structure/mineral_door/wood,
/obj/effect/decal/cleanable/trail_holder{
	color = "#dc0000";
	dir = 8
	},
/turf/open/floor/wood,
/area/ruin/lavaland/unpowered)
"n" = (
/turf/open/floor/plating/asteroid/basalt/lava_land_surface,
/area/lavaland/surface/outdoors)
"o" = (
/obj/item/reagent_containers/food/drinks/beer,
/turf/open/floor/wood,
/area/ruin/lavaland/unpowered)
"p" = (
/obj/machinery/light/broken{
	dir = 4
	},
/obj/effect/decal/cleanable/trail_holder{
	color = "#dc0000";
	dir = 6
	},
/turf/open/floor/wood,
/area/ruin/lavaland/unpowered)
"q" = (
/obj/structure/table/wood,
/obj/item/pen,
/obj/machinery/light/broken{
	dir = 8
	},
/obj/item/paper/crumpled/bloody{
	info = "help...";
	text = ""
	},
/turf/open/floor/wood,
/area/ruin/lavaland/unpowered)
"r" = (
/obj/item/chair/wood,
/obj/effect/decal/cleanable/blood/splatter,
/obj/effect/decal/cleanable/blood/drip,
/mob/living/simple_animal/hostile/megafauna/blood_drunk_miner/guidance{
	dir = 8
	},
/turf/open/floor/wood,
/area/ruin/lavaland/unpowered)
"s" = (
/obj/effect/decal/cleanable/trail_holder{
	color = "#dc0000";
	dir = 9
	},
/turf/open/floor/wood,
/area/ruin/lavaland/unpowered)
"x" = (
/obj/effect/decal/cleanable/trail_holder{
	color = "#dc0000";
	dir = 8
	},
/turf/open/floor/wood,
/area/ruin/lavaland/unpowered)
"N" = (
/obj/effect/decal/cleanable/trail_holder{
	color = "#dc0000";
	dir = 8
	},
/turf/open/floor/plating/asteroid/basalt/lava_land_surface,
/area/lavaland/surface/outdoors)
"Q" = (
/obj/effect/decal/cleanable/trail_holder{
	color = "#dc0000";
	dir = 6
	},
/turf/open/floor/wood,
/area/ruin/lavaland/unpowered)

(1,1,1) = {"
i
i
i
i
i
i
i
i
i
i
i
i
i
i
i
i
i
i
i
i
i
i
i
i
i
"}
(2,1,1) = {"
i
i
i
i
i
i
i
i
i
i
i
i
i
i
i
i
i
i
i
i
i
i
i
i
i
"}
(3,1,1) = {"
i
i
i
i
i
i
i
i
i
i
i
i
i
i
i
i
i
i
i
i
i
i
i
i
i
"}
(4,1,1) = {"
i
i
i
i
i
i
i
i
i
i
i
i
i
i
i
i
i
i
i
i
i
i
i
i
i
"}
(5,1,1) = {"
i
i
i
i
i
i
i
i
i
i
i
i
i
i
i
i
i
i
i
i
i
i
i
i
i
"}
(6,1,1) = {"
i
i
i
i
i
i
i
i
i
i
i
i
i
i
i
i
i
i
i
i
i
i
i
i
i
"}
(7,1,1) = {"
i
i
i
i
i
i
i
i
i
i
i
i
i
i
i
i
i
i
i
i
i
i
i
i
i
"}
(8,1,1) = {"
i
i
i
i
i
i
i
i
i
i
i
i
i
i
i
i
i
i
i
i
i
i
i
i
i
"}
(9,1,1) = {"
i
i
i
i
i
i
i
i
d
b
b
b
b
b
b
b
i
i
i
i
i
i
i
i
i
"}
(10,1,1) = {"
i
i
i
i
i
i
i
i
b
b
b
b
b
b
b
b
b
i
i
i
i
i
i
i
i
"}
(11,1,1) = {"
i
i
i
i
i
i
i
i
b
b
c
f
f
o
q
b
b
i
i
i
i
i
i
i
i
"}
(12,1,1) = {"
i
i
i
i
i
i
i
i
b
b
e
f
f
f
r
b
b
i
i
i
i
i
i
i
i
"}
(13,1,1) = {"
i
i
i
i
i
i
i
i
b
b
f
f
f
f
x
b
b
i
i
i
i
i
i
i
i
"}
(14,1,1) = {"
i
i
i
i
i
i
i
i
b
b
g
f
f
f
x
b
b
i
i
i
i
i
i
i
i
"}
(15,1,1) = {"
i
i
i
i
i
i
i
i
b
b
f
f
f
f
x
b
b
i
i
i
i
i
i
i
i
"}
(16,1,1) = {"
i
i
i
i
i
i
i
i
b
b
j
f
f
f
x
b
b
i
i
i
i
i
i
i
i
"}
(17,1,1) = {"
i
i
i
i
i
i
i
i
b
b
k
f
f
f
x
b
b
i
i
i
i
i
i
i
i
"}
(18,1,1) = {"
i
i
i
i
i
i
i
i
b
b
l
f
f
s
Q
b
b
i
i
i
i
i
i
i
i
"}
(19,1,1) = {"
i
i
i
i
i
i
i
i
b
b
b
f
s
p
b
b
b
i
i
i
i
i
i
i
i
"}
(20,1,1) = {"
i
i
i
i
i
i
i
i
i
b
b
b
x
b
b
b
i
i
i
i
i
i
i
i
i
"}
(21,1,1) = {"
i
i
i
i
i
i
i
i
i
i
i
b
x
b
i
i
i
i
i
i
i
i
i
i
i
"}
(22,1,1) = {"
i
i
i
i
i
i
i
i
i
i
i
b
x
b
i
i
i
i
i
i
i
i
i
i
i
"}
(23,1,1) = {"
i
i
i
i
i
i
i
i
i
i
i
b
x
b
i
i
i
i
i
i
i
i
i
i
i
"}
(24,1,1) = {"
i
i
i
i
i
i
i
i
i
i
i
b
m
b
i
i
i
i
i
i
i
i
i
i
i
"}
(25,1,1) = {"
i
i
i
i
i
i
i
i
i
i
n
h
N
h
n
i
i
i
i
i
i
i
i
i
i
"}
(26,1,1) = {"
i
i
i
i
i
i
i
i
i
n
n
n
h
n
n
n
i
i
i
i
i
i
i
i
i
"}
(27,1,1) = {"
i
i
i
i
i
i
i
i
n
n
n
n
n
n
n
n
n
i
i
i
i
i
i
i
i
"}
(28,1,1) = {"
i
i
i
i
i
i
i
n
n
n
n
n
n
n
n
n
n
n
i
i
i
i
i
i
i
"}
(29,1,1) = {"
i
i
i
i
i
i
i
n
n
n
n
n
n
n
n
n
n
n
i
i
i
i
i
i
i
"}
