"a" = (/turf/template_noop,/area/template_noop)
"b" = (/turf/closed/mineral/volcanic/lava_land_surface,/area/lavaland/underground)
"c" = (/turf/template_noop,/area/lavaland/underground)
"d" = (/turf/open/floor/plating/asteroid/basalt/lava_land_surface,/area/lavaland/underground)
"e" = (/obj/effect/decal/remains/human,/turf/open/floor/plating/asteroid/basalt/lava_land_surface,/area/lavaland/underground)
"f" = (/turf/open/floor/plating/lava/smooth/lava_land_surface,/area/lavaland/underground)
"g" = (/turf/closed/indestructible/riveted{icon = 'icons/turf/walls/iron_wall.dmi'; icon_state = "iron"; name = "dense wall"},/area/ruin/powered)
"h" = (/obj/structure/table,/turf/open/floor/plasteel/black{baseturf = /turf/open/floor/plating/lava/smooth/lava_land_surface},/area/ruin/powered)
"i" = (/turf/open/floor/plasteel/black{baseturf = /turf/open/floor/plating/lava/smooth/lava_land_surface},/area/ruin/powered)
"j" = (/mob/living/simple_animal/hostile/skeleton,/turf/open/floor/plasteel/black{baseturf = /turf/open/floor/plating/lava/smooth/lava_land_surface},/area/ruin/powered)
"k" = (/obj/structure/bodycontainer/morgue{desc = "An oddly modernized tomb, at least compared to where it currently is."; name = "tomb"},/obj/effect/mob_spawn/human/skeleton,/turf/open/floor/plasteel/black{baseturf = /turf/open/floor/plating/lava/smooth/lava_land_surface},/area/ruin/powered)
"l" = (/obj/item/weapon/grown/bananapeel,/obj/structure/mineral_door/transparent/diamond,/turf/open/floor/vault{baseturf = /turf/open/floor/plating/lava/smooth/lava_land_surface},/area/ruin/powered)
"m" = (/obj/item/weapon/ore/diamond,/turf/open/floor/plasteel/black{baseturf = /turf/open/floor/plating/lava/smooth/lava_land_surface},/area/ruin/powered)
"n" = (/turf/open/floor/vault{baseturf = /turf/open/floor/plating/lava/smooth/lava_land_surface},/area/ruin/powered)
"o" = (/obj/item/weapon/ore/gold,/turf/open/floor/plasteel/black{baseturf = /turf/open/floor/plating/lava/smooth/lava_land_surface},/area/ruin/powered)
"p" = (/turf/open/floor/plating/lava/smooth/lava_land_surface{initial_gas_mix = "o2=22;n2=82;TEMP=293.15"},/area/ruin/powered)
"q" = (/obj/structure/table,/obj/item/weapon/tome,/turf/open/floor/plasteel/black{baseturf = /turf/open/floor/plating/lava/smooth/lava_land_surface},/area/ruin/powered)
"r" = (/obj/item/weapon/grown/bananapeel,/obj/structure/mineral_door/silver,/turf/open/floor/vault{baseturf = /turf/open/floor/plating/lava/smooth/lava_land_surface},/area/ruin/powered)
"s" = (/obj/item/weapon/ore/bananium,/turf/open/floor/plasteel/black{baseturf = /turf/open/floor/plating/lava/smooth/lava_land_surface},/area/ruin/powered)
"t" = (/obj/item/weapon/grown/bananapeel,/obj/structure/mineral_door/gold,/turf/open/floor/vault{baseturf = /turf/open/floor/plating/lava/smooth/lava_land_surface},/area/ruin/powered)
"u" = (/obj/structure/table/optable/abductor{desc = "A strange, alien-like table for cutting up things, like people."; name = "strange alien slab"},/obj/effect/gibspawner/human,/obj/effect/mob_spawn/human/skeleton,/obj/item/weapon/veilrender/honkrender,/obj/item/clothing/mask/gas/clown_hat,/turf/open/floor/vault{baseturf = /turf/open/floor/plating/lava/smooth/lava_land_surface},/area/ruin/powered)
"v" = (/obj/structure/table,/obj/item/weapon/spellbook/oneuse/charge,/turf/open/floor/plasteel/black{baseturf = /turf/open/floor/plating/lava/smooth/lava_land_surface},/area/ruin/powered)
"w" = (/obj/structure/bodycontainer/morgue{desc = "An oddly modernized tomb, at least compared to where it currently is."; name = "tomb"},/obj/effect/mob_spawn/human/skeleton{helmet = /obj/item/clothing/head/ushanka; name = "russian remains"; uniform = /obj/item/clothing/under/soviet},/turf/open/floor/plasteel/black{baseturf = /turf/open/floor/plating/lava/smooth/lava_land_surface},/area/ruin/powered)
"x" = (/obj/item/weapon/ore/uranium,/turf/open/floor/plasteel/black{baseturf = /turf/open/floor/plating/lava/smooth/lava_land_surface},/area/ruin/powered)
"y" = (/obj/item/weapon/ore/plasma,/turf/open/floor/plasteel/black{baseturf = /turf/open/floor/plating/lava/smooth/lava_land_surface},/area/ruin/powered)
"z" = (/obj/item/weapon/grown/bananapeel,/obj/structure/mineral_door/iron,/turf/open/floor/vault{baseturf = /turf/open/floor/plating/lava/smooth/lava_land_surface},/area/ruin/powered)
"A" = (/obj/structure/table,/obj/item/weapon/twohanded/spear,/obj/item/weapon/shield/riot/buckler,/turf/open/floor/plasteel/black{baseturf = /turf/open/floor/plating/lava/smooth/lava_land_surface},/area/ruin/powered)
"B" = (/obj/item/weapon/grown/bananapeel,/obj/structure/mineral_door/iron,/turf/open/floor/plasteel/black{baseturf = /turf/open/floor/plating/lava/smooth/lava_land_surface},/area/ruin/powered)

(1,1,1) = {"
aaaaaaaaaaaaaaaaaaaaaaaaa
aaaaaaabbaaaaaaaaaaaaaaaa
aaaaabbbbbcbbbbbbbbaaaaaa
aaabbbbbbbdebbbedfdaaaaaa
aaaabbbgggggggggggbbaaaaa
aaaeddeghiijijiihgbbbbdaa
aaaddfbgikiikiikigdebbbaa
aaadebggjiiiiiiijggdebbaa
aadbbgggggglglggggggddfaa
aabggggmnnnninnnnoggggbba
aabgkjgnmippippiongkjgbbb
bbbghignnpipipipnngqigbda
bdegjirnnppnsnppnntijgbea
bdbgkigiiiisusiiiigkigbba
aebgjirnnppnsnppnntijgeba
adbgvignnpipipipnnghigfda
abbgwjgnxippippiyngkjgbda
abbggggxnnnninnnnyggggbba
adebbbgggggzgzgggggbbbbba
aadfbfeggAiiiiiAggbbebbaa
aadfffbbgAijijiAgbeddbbaa
aaaddebbgAiiiiiAgedfaaaaa
aaaaadbbgggBgBgggbddaaaaa
aaaaaaabbbbbdbbbbbdaaaaaa
aaaaaaabbbbbdbbbbbdaaaaaa
"}
