//MAP CONVERTED BY dmm2tgm.py THIS HEADER COMMENT PREVENTS RECONVERSION, DO NOT REMOVE
"aa" = (
/turf/template_noop,
/area/template_noop)
"ab" = (
/obj/structure/table/wood/fancy/black,
/obj/item/documents/syndicate/mining,
/obj/effect/decal/cleanable/cobweb,
/turf/open/floor/plasteel/cult,
/area/ruin/lavaland/unpowered/buried_library)
"ac" = (
/turf/closed/wall/mineral/wood,
/area/ruin/lavaland/unpowered/buried_library)
"ad" = (
/turf/open/floor/plating/asteroid/basalt/lava_land_surface,
/area/lavaland/surface/outdoors)
"ae" = (
/turf/open/floor/wood,
/area/ruin/lavaland/unpowered/buried_library)
"af" = (
/obj/item/stack/sheet/mineral/wood,
/turf/open/floor/wood,
/area/ruin/lavaland/unpowered/buried_library)
"ag" = (
/obj/item/feather,
/turf/open/floor/wood,
/area/ruin/lavaland/unpowered/buried_library)
"ah" = (
/obj/structure/bookcase/random,
/turf/open/floor/wood,
/area/ruin/lavaland/unpowered/buried_library)
"ai" = (
/obj/structure/table/wood/fancy/black,
/obj/item/paper/crumpled/fluff/stations/lavaland/library/diary2,
/obj/effect/decal/cleanable/cobweb/cobweb2,
/turf/open/floor/plasteel/cult,
/area/ruin/lavaland/unpowered/buried_library)
"al" = (
/turf/closed/wall/mineral/iron,
/area/ruin/lavaland/unpowered/buried_library)
"am" = (
/obj/structure/table/wood/fancy/black,
/obj/item/book_of_babel,
/turf/open/floor/plasteel/cult,
/area/ruin/lavaland/unpowered/buried_library)
"ao" = (
/obj/effect/decal/cleanable/dirt,
/turf/open/floor/wood,
/area/ruin/lavaland/unpowered/buried_library)
"ap" = (
/obj/item/stack/sheet/mineral/wood,
/obj/effect/decal/cleanable/dirt,
/turf/open/floor/wood,
/area/ruin/lavaland/unpowered/buried_library)
"aq" = (
/obj/structure/bookcase/random,
/turf/open/floor/plating/asteroid/basalt/lava_land_surface,
/area/ruin/lavaland/unpowered/buried_library)
"ar" = (
/turf/open/floor/plasteel/cult,
/area/ruin/lavaland/unpowered/buried_library)
"as" = (
/obj/effect/decal/cleanable/dirt,
/obj/item/paper/fluff/ruins/oldstation/protosing,
/turf/open/floor/plating/asteroid/basalt/lava_land_surface,
/area/ruin/lavaland/unpowered/buried_library)
"aw" = (
/turf/open/floor/plating,
/area/ruin/lavaland/unpowered/buried_library)
"ay" = (
/obj/machinery/door/keycard/library,
/turf/open/floor/plasteel/cult,
/area/ruin/lavaland/unpowered/buried_library)
"az" = (
/obj/item/paper/crumpled/fluff/stations/lavaland/library/diary,
/turf/open/floor/wood,
/area/ruin/lavaland/unpowered/buried_library)
"aA" = (
/obj/effect/decal/cleanable/dirt,
/turf/open/floor/plating,
/area/ruin/lavaland/unpowered/buried_library)
"aC" = (
/obj/item/feather,
/turf/open/floor/plating/asteroid/basalt/lava_land_surface,
/area/ruin/lavaland/unpowered/buried_library)
"aD" = (
/turf/open/floor/carpet/black,
/area/ruin/lavaland/unpowered/buried_library)
"aE" = (
/obj/item/stack/sheet/mineral/wood,
/obj/item/book/manual/random,
/turf/open/floor/wood,
/area/ruin/lavaland/unpowered/buried_library)
"aF" = (
/obj/item/book/manual/random,
/obj/effect/decal/cleanable/dirt,
/turf/open/floor/plating/asteroid/basalt/lava_land_surface,
/area/ruin/lavaland/unpowered/buried_library)
"aG" = (
/obj/structure/table/bronze,
/obj/item/stack/ore/slag,
/turf/open/floor/carpet/black,
/area/ruin/lavaland/unpowered/buried_library)
"aH" = (
/obj/structure/table/bronze,
/obj/item/statuebust,
/turf/open/floor/carpet/black,
/area/ruin/lavaland/unpowered/buried_library)
"aI" = (
/obj/effect/mob_spawn/human/skeleton,
/turf/open/floor/plasteel/cult,
/area/ruin/lavaland/unpowered/buried_library)
"aJ" = (
/obj/effect/decal/cleanable/dirt,
/turf/open/floor/plasteel/cult,
/area/ruin/lavaland/unpowered/buried_library)
"aK" = (
/obj/item/feather,
/obj/effect/decal/cleanable/dirt,
/turf/open/floor/plasteel/cult,
/area/ruin/lavaland/unpowered/buried_library)
"aL" = (
/obj/effect/decal/cleanable/dirt,
/obj/structure/fluff/paper/stack,
/turf/open/floor/wood,
/area/ruin/lavaland/unpowered/buried_library)
"aM" = (
/obj/item/stack/sheet/mineral/wood,
/obj/item/book/manual/random,
/turf/open/floor/plating/asteroid/basalt/lava_land_surface,
/area/ruin/lavaland/unpowered/buried_library)
"aN" = (
/obj/structure/statue/sandstone/venus,
/turf/open/floor/carpet/black,
/area/ruin/lavaland/unpowered/buried_library)
"aP" = (
/obj/item/keycard/library,
/turf/open/floor/plating/asteroid/basalt/lava_land_surface,
/area/ruin/lavaland/unpowered/buried_library)
"aQ" = (
/obj/effect/decal/cleanable/dirt,
/obj/item/paper/fluff/awaymissions/moonoutpost19/research/larva_autopsy,
/turf/open/floor/wood,
/area/ruin/lavaland/unpowered/buried_library)
"aR" = (
/obj/structure/fluff/paper/stack,
/turf/open/floor/wood,
/area/ruin/lavaland/unpowered/buried_library)
"aS" = (
/obj/structure/table/wood/fancy/black,
/obj/effect/decal/cleanable/dirt,
/obj/item/paper/secretrecipe,
/obj/item/flashlight/lantern/jade{
	on = 1
	},
/turf/open/floor/plasteel/cult,
/area/ruin/lavaland/unpowered/buried_library)
"aV" = (
/obj/item/stack/sheet/mineral/wood,
/obj/structure/fluff/paper/stack,
/turf/open/floor/wood,
/area/ruin/lavaland/unpowered/buried_library)
"aW" = (
/obj/structure/fluff/paper/stack,
/turf/open/floor/plasteel/cult,
/area/ruin/lavaland/unpowered/buried_library)
"aX" = (
/obj/structure/table/bronze,
/obj/item/statuebust,
/turf/open/floor/plating,
/area/ruin/lavaland/unpowered/buried_library)
"aY" = (
/obj/structure/table_frame/wood,
/turf/open/floor/plating,
/area/ruin/lavaland/unpowered/buried_library)
"ba" = (
/obj/structure/barricade/wooden/crude,
/turf/open/floor/plating/asteroid/basalt/lava_land_surface,
/area/ruin/lavaland/unpowered/buried_library)
"bg" = (
/obj/item/paper/fluff/ruins/oldstation/protogun,
/turf/open/floor/plating/asteroid/basalt/lava_land_surface,
/area/ruin/lavaland/unpowered/buried_library)
"bh" = (
/obj/effect/decal/cleanable/dirt,
/mob/living/simple_animal/pet/fox,
/turf/open/floor/wood,
/area/ruin/lavaland/unpowered/buried_library)
"bi" = (
/turf/open/floor/plating/asteroid/basalt/lava_land_surface,
/area/ruin/lavaland/unpowered/buried_library)
"bj" = (
/obj/item/book/manual/random,
/turf/open/floor/plating/asteroid/basalt/lava_land_surface,
/area/ruin/lavaland/unpowered/buried_library)
"bl" = (
/obj/item/storage/box/fountainpens,
/turf/open/floor/plating/asteroid/basalt/lava_land_surface,
/area/ruin/lavaland/unpowered/buried_library)
"bm" = (
/obj/structure/fluff/paper/stack,
/turf/open/floor/plating/asteroid/basalt/lava_land_surface,
/area/ruin/lavaland/unpowered/buried_library)
"bn" = (
/obj/item/book/manual/random,
/obj/item/stack/sheet/mineral/wood,
/turf/open/floor/plating/asteroid/basalt/lava_land_surface,
/area/ruin/lavaland/unpowered/buried_library)
"bo" = (
/obj/item/stack/sheet/mineral/wood,
/turf/open/floor/plating/asteroid/basalt/lava_land_surface,
/area/ruin/lavaland/unpowered/buried_library)
"bp" = (
/obj/effect/decal/cleanable/dirt,
/turf/open/floor/plating/asteroid/basalt/lava_land_surface,
/area/ruin/lavaland/unpowered/buried_library)
"bq" = (
/obj/structure/mineral_door/wood,
/turf/open/floor/wood,
/area/ruin/lavaland/unpowered/buried_library)
"br" = (
/obj/structure/girder,
/turf/open/floor/plating/asteroid/basalt/lava_land_surface,
/area/ruin/lavaland/unpowered/buried_library)
"bt" = (
/obj/effect/decal/cleanable/dirt,
/turf/template_noop,
/area/template_noop)
"bu" = (
/obj/item/stack/sheet/mineral/wood,
/turf/open/floor/plating/asteroid/basalt/lava_land_surface,
/area/lavaland/surface/outdoors)
"bw" = (
/turf/open/floor/wood,
/area/lavaland/surface/outdoors)
"by" = (
/obj/item/statuebust,
/turf/open/floor/carpet/black,
/area/ruin/lavaland/unpowered/buried_library)
"bz" = (
/obj/item/flashlight/lantern/jade{
	on = 1
	},
/turf/open/floor/plating,
/area/ruin/lavaland/unpowered/buried_library)
"bA" = (
/obj/structure/fluff/paper/stack,
/turf/open/floor/plating,
/area/ruin/lavaland/unpowered/buried_library)
"bB" = (
/obj/structure/fluff/paper/stack,
/turf/open/floor/carpet/black,
/area/ruin/lavaland/unpowered/buried_library)

(1,1,1) = {"
aa
aa
aa
aa
aa
aa
aa
aa
aa
aa
aa
aa
aa
aa
ad
ad
ad
ad
ad
ad
ad
bt
aa
"}
(2,1,1) = {"
aa
aa
aa
aa
aa
aa
aa
aa
aa
aa
bi
bi
bi
bi
bi
ac
ba
ac
ac
ac
ad
ad
aa
"}
(3,1,1) = {"
aa
aa
aa
aa
aa
aa
aa
bi
bi
bi
bi
bo
bi
bi
bi
bm
ae
af
ae
ac
ad
ad
aa
"}
(4,1,1) = {"
aa
aa
aa
aa
aa
aa
bi
bi
aR
bi
bi
ae
bj
aq
bi
ah
aL
ah
ao
ac
ad
aa
aa
"}
(5,1,1) = {"
aa
aa
aa
aa
aa
bi
bi
bi
aC
ae
aQ
ah
bi
aq
bg
ah
ao
ah
bi
ac
ad
ad
aa
"}
(6,1,1) = {"
aa
aa
aa
aa
ad
ac
bi
ae
bi
aM
ae
ah
bm
aq
aA
ah
ao
ah
ae
ac
ad
ad
ad
"}
(7,1,1) = {"
aa
aa
aa
aa
ad
ac
bi
bm
bi
ao
aR
ao
aA
ao
ag
ah
aR
ah
bh
ac
ad
ad
ad
"}
(8,1,1) = {"
aa
aa
aa
aa
ad
bi
bi
aq
aA
bi
aG
aD
aX
bi
ao
ae
ao
ah
ae
ac
br
ad
ad
"}
(9,1,1) = {"
aa
aa
aa
aa
ad
ac
as
aq
aF
aD
aD
bz
aD
bB
bi
ae
ao
ae
ao
ac
bp
bw
ad
"}
(10,1,1) = {"
aa
aa
aa
ad
ad
ac
ap
bp
bi
aD
aD
aN
bi
aw
bi
ao
af
aR
ae
bq
ae
bu
ad
"}
(11,1,1) = {"
aa
al
al
al
al
al
ae
ah
aR
aD
bi
aD
aD
by
ao
aw
ao
ae
bm
ac
ae
ad
ad
"}
(12,1,1) = {"
ad
al
ab
aI
ar
al
aR
aE
af
aD
aH
bA
aY
aD
bi
ae
bm
aq
ag
br
ac
ad
ad
"}
(13,1,1) = {"
ad
al
am
aJ
aW
ay
ae
ah
ao
ae
ao
ae
af
bp
bi
aq
bi
aq
bp
ac
ad
ad
ad
"}
(14,1,1) = {"
ad
al
aS
aW
aK
al
ae
ah
bi
ah
ao
ah
az
aq
bi
aq
bi
bn
ao
ac
ad
aa
aa
"}
(15,1,1) = {"
ad
al
al
ai
ar
al
ag
ah
aL
ah
aA
ah
ao
aq
bi
bi
bl
bi
bi
bi
ad
aa
aa
"}
(16,1,1) = {"
ad
ad
al
al
al
al
ao
ah
ao
ah
ao
aV
bi
aq
bp
bi
bm
bo
bi
br
bu
aa
aa
"}
(17,1,1) = {"
aa
ad
ad
ad
ad
ac
ae
ao
ae
aP
ae
aR
ae
bp
bi
bj
bi
ad
ad
ad
aa
aa
aa
"}
(18,1,1) = {"
aa
aa
aa
aa
ad
ac
ac
ac
ac
ac
ac
ba
ac
ac
br
ad
aa
ad
aa
aa
aa
aa
aa
"}
(19,1,1) = {"
aa
aa
aa
aa
aa
ad
ad
ad
ad
ad
ad
aa
ad
ad
aa
aa
aa
aa
aa
aa
aa
aa
aa
"}
