//MAP CONVERTED BY dmm2tgm.py THIS HEADER COMMENT PREVENTS RECONVERSION, DO NOT REMOVE
"a" = (
/turf/template_noop,
/area/template_noop)
"b" = (
/turf/closed/wall/mineral/silver,
/area/ruin/lavaland/powered/bathhouse)
"c" = (
/obj/machinery/shower{
	pixel_y = 16
	},
/obj/structure/curtain,
/turf/open/floor/plasteel/white,
/area/ruin/lavaland/powered/bathhouse)
"e" = (
/obj/structure/mirror{
	pixel_y = 28
	},
/obj/structure/sink{
	pixel_y = 20
	},
/turf/open/floor/plasteel/white,
/area/ruin/lavaland/powered/bathhouse)
"f" = (
/obj/structure/table/greyscale,
/obj/item/bikehorn/rubberducky,
/turf/open/floor/plasteel/white,
/area/ruin/lavaland/powered/bathhouse)
"g" = (
/turf/open/floor/plasteel/white,
/area/ruin/lavaland/powered/bathhouse)
"h" = (
/obj/item/soap,
/turf/open/floor/plasteel/white,
/area/ruin/lavaland/powered/bathhouse)
"i" = (
/obj/machinery/door/airlock/freezer{
	name = "bath house airlock"
	},
/turf/open/floor/plasteel/white,
/area/ruin/lavaland/powered/bathhouse)
"j" = (
/turf/closed/wall/mineral/wood,
/area/ruin/lavaland/powered/bathhouse)
"k" = (
/turf/open/floor/wood,
/area/ruin/lavaland/powered/bathhouse)
"l" = (
/obj/structure/table/wood,
/obj/item/reagent_containers/food/snacks/meatballspaghetti,
/turf/open/floor/wood,
/area/ruin/lavaland/powered/bathhouse)
"m" = (
/obj/structure/bookcase/random,
/turf/open/floor/wood,
/area/ruin/lavaland/powered/bathhouse)
"n" = (
/turf/open/floor/plating/asteroid/basalt/lava_land_surface,
/area/lavaland/surface/outdoors)
"o" = (
/obj/structure/bed,
/obj/item/bedsheet,
/turf/open/floor/wood,
/area/ruin/lavaland/powered/bathhouse)

(1,1,1) = {"
b
b
b
b
b
n
a
a
"}
(2,1,1) = {"
b
c
g
g
b
j
j
j
"}
(3,1,1) = {"
b
b
g
g
i
k
k
j
"}
(4,1,1) = {"
b
c
g
g
b
l
k
j
"}
(5,1,1) = {"
b
b
g
g
b
m
o
j
"}
(6,1,1) = {"
b
c
g
g
b
j
j
j
"}
(7,1,1) = {"
b
b
g
h
b
n
n
n
"}
(8,1,1) = {"
b
e
g
g
b
n
n
n
"}
(9,1,1) = {"
b
e
g
g
i
n
n
n
"}
(10,1,1) = {"
b
f
g
g
b
n
n
a
"}
(11,1,1) = {"
b
b
b
b
b
n
a
a
"}
