"aa" = (/turf/template_noop,/area/template_noop)
"ab" = (/turf/open/lava/smooth/lava_land_surface,/area/lavaland/surface/outdoors)
"ac" = (/obj/structure/alien/resin/wall,/obj/structure/alien/weeds,/turf/open/floor/plating/asteroid/basalt/lava_land_surface,/area/ruin/unpowered/xenonest)
"ad" = (/obj/structure/alien/weeds,/obj/effect/decal/cleanable/blood/gibs,/turf/open/floor/plating/asteroid/basalt/lava_land_surface,/area/ruin/unpowered/xenonest)
"ae" = (/obj/structure/alien/weeds,/mob/living/simple_animal/hostile/alien/maid,/turf/open/floor/plating/asteroid/basalt/lava_land_surface,/area/ruin/unpowered/xenonest)
"af" = (/obj/structure/alien/weeds,/obj/structure/alien/egg/burst,/turf/open/floor/plating/asteroid/basalt/lava_land_surface,/area/ruin/unpowered/xenonest)
"ag" = (/obj/structure/alien/weeds,/turf/open/floor/plating/asteroid/basalt/lava_land_surface,/area/ruin/unpowered/xenonest)
"ah" = (/obj/structure/bed/nest,/obj/structure/alien/weeds,/turf/open/floor/plating/asteroid/basalt/lava_land_surface,/area/ruin/unpowered/xenonest)
"ai" = (/obj/structure/alien/weeds,/obj/effect/mob_spawn/alien/corpse/humanoid/praetorian,/turf/open/floor/plating/asteroid/basalt/lava_land_surface,/area/ruin/unpowered/xenonest)
"aj" = (/obj/structure/alien/weeds,/obj/structure/bed/nest,/obj/item/clothing/mask/facehugger/impregnated,/obj/item/storage/backpack/clown,/obj/item/bikehorn,/turf/open/floor/plating/asteroid/basalt/lava_land_surface,/area/ruin/unpowered/xenonest)
"ak" = (/obj/structure/alien/resin/membrane,/obj/structure/alien/weeds,/turf/open/floor/plating/asteroid/basalt/lava_land_surface,/area/ruin/unpowered/xenonest)
"al" = (/obj/structure/alien/weeds,/mob/living/simple_animal/hostile/alien/drone,/turf/open/floor/plating/asteroid/basalt/lava_land_surface,/area/ruin/unpowered/xenonest)
"am" = (/obj/structure/alien/weeds,/obj/structure/bed/nest,/turf/open/floor/plating/asteroid/basalt/lava_land_surface,/area/ruin/unpowered/xenonest)
"an" = (/turf/closed/mineral/volcanic/lava_land_surface,/area/lavaland/surface/outdoors)
"ao" = (/obj/structure/alien/weeds/node,/obj/effect/decal/cleanable/blood,/turf/open/floor/plating/asteroid/basalt/lava_land_surface,/area/ruin/unpowered/xenonest)
"ap" = (/obj/structure/bed/nest,/obj/structure/alien/weeds,/obj/item/clothing/mask/facehugger/impregnated,/obj/item/clothing/glasses/night,/obj/item/clothing/gloves/tackler/combat/insulated,/obj/effect/decal/cleanable/blood/old,/obj/item/clothing/under/syndicate/tacticool,/turf/open/floor/plating/asteroid/basalt/lava_land_surface,/area/ruin/unpowered/xenonest)
"aq" = (/obj/structure/alien/weeds,/obj/structure/alien/egg/burst,/obj/effect/decal/cleanable/blood,/turf/open/floor/plating/asteroid/basalt/lava_land_surface,/area/ruin/unpowered/xenonest)
"ar" = (/obj/structure/alien/weeds/node,/turf/open/floor/plating/asteroid/basalt/lava_land_surface,/area/ruin/unpowered/xenonest)
"as" = (/obj/structure/alien/resin/wall,/obj/structure/alien/weeds,/obj/structure/alien/weeds,/turf/open/floor/plating/asteroid/basalt/lava_land_surface,/area/ruin/unpowered/xenonest)
"at" = (/obj/structure/alien/weeds,/obj/structure/alien/resin/wall,/turf/open/floor/plating/asteroid/basalt/lava_land_surface,/area/ruin/unpowered/xenonest)
"au" = (/obj/structure/alien/weeds,/obj/item/grown/bananapeel,/turf/open/floor/plating/asteroid/basalt/lava_land_surface,/area/ruin/unpowered/xenonest)
"av" = (/obj/structure/alien/weeds,/mob/living/simple_animal/hostile/alien/sentinel,/turf/open/floor/plating/asteroid/basalt/lava_land_surface,/area/ruin/unpowered/xenonest)
"aw" = (/obj/structure/alien/weeds,/obj/structure/alien/resin/membrane,/turf/open/floor/plating/asteroid/basalt/lava_land_surface,/area/ruin/unpowered/xenonest)
"ax" = (/obj/structure/alien/weeds,/obj/effect/decal/cleanable/blood/gibs,/obj/structure/alien/weeds/node,/mob/living/simple_animal/hostile/alien/drone,/turf/open/floor/plating/asteroid/basalt/lava_land_surface,/area/ruin/unpowered/xenonest)
"ay" = (/turf/open/indestructible/boss,/area/ruin/unpowered/xenonest)
"az" = (/obj/structure/stone_tile/block{dir = 4},/turf/open/indestructible/boss,/area/ruin/unpowered/xenonest)
"aA" = (/obj/structure/alien/weeds,/obj/item/flamethrower,/turf/open/floor/plating/asteroid/basalt/lava_land_surface,/area/ruin/unpowered/xenonest)
"aB" = (/obj/structure/alien/weeds,/obj/item/ammo_casing/c45,/obj/effect/decal/cleanable/blood/gibs,/mob/living/simple_animal/hostile/alien/sentinel,/turf/open/floor/plating/asteroid/basalt/lava_land_surface,/area/ruin/unpowered/xenonest)
"aC" = (/obj/structure/alien/weeds,/obj/item/ammo_casing/c45{pixel_x = -6},/turf/open/floor/plating/asteroid/basalt/lava_land_surface,/area/ruin/unpowered/xenonest)
"aD" = (/obj/structure/stone_tile/surrounding_tile{dir = 1},/obj/structure/stone_tile/surrounding_tile,/obj/structure/stone_tile/surrounding_tile/cracked{dir = 4},/turf/open/chasm/lavaland,/area/ruin/unpowered/xenonest)
"aE" = (/obj/structure/alien/weeds,/obj/effect/decal/cleanable/ash,/turf/open/floor/plating/asteroid/basalt/lava_land_surface,/area/ruin/unpowered/xenonest)
"aF" = (/obj/structure/alien/weeds,/mob/living/simple_animal/hostile/alien,/turf/open/floor/plating/asteroid/basalt/lava_land_surface,/area/ruin/unpowered/xenonest)
"aG" = (/obj/structure/alien/weeds,/obj/structure/mecha_wreckage/ripley,/turf/open/floor/plating/asteroid/basalt/lava_land_surface,/area/ruin/unpowered/xenonest)
"aH" = (/obj/structure/alien/weeds,/obj/effect/decal/cleanable/blood/tracks,/turf/open/floor/plating/asteroid/basalt/lava_land_surface,/area/ruin/unpowered/xenonest)
"aI" = (/obj/structure/alien/weeds,/obj/effect/decal/cleanable/vomit/old,/turf/open/floor/plating/asteroid/basalt/lava_land_surface,/area/ruin/unpowered/xenonest)
"aJ" = (/obj/structure/alien/weeds,/obj/effect/decal/cleanable/blood,/turf/open/floor/plating/asteroid/basalt/lava_land_surface,/area/ruin/unpowered/xenonest)
"aK" = (/obj/structure/stone_tile/surrounding_tile/cracked{dir = 4},/obj/structure/stone_tile/surrounding_tile/cracked{dir = 8},/turf/open/chasm/lavaland,/area/ruin/unpowered/xenonest)
"aL" = (/obj/structure/alien/weeds,/obj/item/tank/internals/plasma,/turf/open/floor/plating/asteroid/basalt/lava_land_surface,/area/ruin/unpowered/xenonest)
"aM" = (/obj/structure/alien/weeds,/obj/effect/decal/cleanable/blood/xeno,/turf/open/floor/plating/asteroid/basalt/lava_land_surface,/area/ruin/unpowered/xenonest)
"aN" = (/obj/structure/stone_tile/block{dir = 8},/obj/structure/stone_tile{dir = 1},/turf/open/indestructible/boss,/area/ruin/unpowered/xenonest)
"aO" = (/obj/structure/alien/weeds,/obj/effect/mob_spawn/alien/corpse/humanoid/sentinel,/turf/open/floor/plating/asteroid/basalt/lava_land_surface,/area/ruin/unpowered/xenonest)
"aP" = (/obj/structure/alien/weeds,/obj/effect/mob_spawn/alien/corpse/humanoid/hunter,/turf/open/floor/plating/asteroid/basalt/lava_land_surface,/area/ruin/unpowered/xenonest)
"aQ" = (/obj/structure/alien/weeds,/obj/structure/bed/nest,/obj/item/clothing/mask/facehugger/impregnated,/obj/item/clothing/suit/bio_suit/security,/obj/item/clothing/head/bio_hood/security,/obj/item/clothing/mask/breath,/obj/item/flashlight/seclite,/turf/open/floor/plating/asteroid/basalt/lava_land_surface,/area/ruin/unpowered/xenonest)
"aS" = (/obj/structure/alien/weeds,/obj/structure/bed/nest,/obj/item/clothing/mask/facehugger/impregnated,/turf/open/floor/plating/asteroid/basalt/lava_land_surface,/area/ruin/unpowered/xenonest)
"aT" = (/obj/structure/alien/weeds,/obj/item/chainsaw,/turf/open/floor/plating/asteroid/basalt/lava_land_surface,/area/ruin/unpowered/xenonest)
"aU" = (/obj/structure/alien/weeds,/obj/structure/bed/nest,/obj/item/fireaxe/boneaxe,/obj/item/clothing/head/helmet/gladiator,/obj/item/clothing/mask/facehugger/impregnated,/turf/open/floor/plating/asteroid/basalt/lava_land_surface,/area/ruin/unpowered/xenonest)
"aV" = (/obj/structure/alien/weeds,/obj/structure/bed/nest,/obj/item/clothing/mask/facehugger/impregnated,/obj/effect/decal/cleanable/blood,/turf/open/floor/plating/asteroid/basalt/lava_land_surface,/area/ruin/unpowered/xenonest)
"aW" = (/obj/structure/alien/resin/wall,/turf/open/floor/plating/asteroid/basalt/lava_land_surface,/area/ruin/unpowered/xenonest)
"aX" = (/obj/structure/alien/weeds,/obj/effect/gibspawner/xeno,/turf/open/floor/plating/asteroid/basalt/lava_land_surface,/area/ruin/unpowered/xenonest)
"aZ" = (/turf/closed/indestructible/riveted/boss,/area/ruin/unpowered/xenonest)
"ba" = (/obj/structure/stone_tile/slab,/turf/open/indestructible/boss,/area/ruin/unpowered/xenonest)
"bb" = (/obj/structure/stone_tile/cracked{dir = 4},/obj/structure/stone_tile,/obj/structure/stone_tile{dir = 1},/obj/structure/stone_tile{dir = 8},/obj/item/flashlight/lantern,/turf/open/indestructible/boss,/area/ruin/unpowered/xenonest)
"bc" = (/obj/structure/stone_tile/block,/obj/structure/stone_tile{dir = 1},/obj/structure/stone_tile{dir = 4},/turf/open/indestructible/boss,/area/ruin/unpowered/xenonest)
"bd" = (/obj/structure/stone_tile/block,/obj/structure/stone_tile{dir = 4},/obj/structure/stone_tile/cracked{dir = 1},/obj/effect/decal/cleanable/blood/xeno,/turf/open/indestructible/boss,/area/ruin/unpowered/xenonest)
"be" = (/obj/structure/stone_tile/block,/obj/structure/stone_tile{dir = 4},/obj/structure/stone_tile{dir = 1},/turf/open/indestructible/boss,/area/ruin/unpowered/xenonest)
"bf" = (/obj/structure/stone_tile,/obj/structure/stone_tile{dir = 1},/obj/structure/stone_tile{dir = 8},/obj/structure/stone_tile{dir = 4},/obj/item/flashlight/lantern,/turf/open/indestructible/boss,/area/ruin/unpowered/xenonest)
"bg" = (/obj/structure/alien/weeds,/obj/item/clothing/mask/facehugger/dead,/turf/open/floor/plating/asteroid/basalt/lava_land_surface,/area/ruin/unpowered/xenonest)
"bh" = (/obj/structure/stone_tile/block/cracked{dir = 4},/obj/structure/stone_tile/cracked{dir = 4},/obj/structure/stone_tile{dir = 8},/turf/open/indestructible/boss,/area/ruin/unpowered/xenonest)
"bi" = (/obj/structure/alien/weeds,/obj/structure/bed/nest,/obj/item/clothing/mask/facehugger/impregnated,/obj/item/book_of_babel,/obj/item/clothing/head/wizard/black,/turf/open/floor/plating/asteroid/basalt/lava_land_surface,/area/ruin/unpowered/xenonest)
"bj" = (/obj/structure/stone_tile/surrounding_tile/cracked,/obj/structure/stone_tile/surrounding_tile{dir = 8},/obj/structure/stone_tile/surrounding_tile/cracked{dir = 1},/obj/structure/stone_tile/center/cracked,/turf/open/chasm/lavaland,/area/ruin/unpowered/xenonest)
"bk" = (/obj/structure/stone_tile/block,/turf/open/chasm/lavaland,/area/ruin/unpowered/xenonest)
"bl" = (/obj/structure/stone_tile/block{dir = 8},/obj/structure/stone_tile{dir = 1},/obj/structure/stone_tile,/turf/open/indestructible/boss,/area/ruin/unpowered/xenonest)
"bn" = (/obj/structure/stone_tile/block{dir = 4},/obj/structure/stone_tile{dir = 8},/obj/structure/stone_tile{dir = 4},/turf/open/indestructible/boss,/area/ruin/unpowered/xenonest)
"bo" = (/obj/structure/stone_tile/surrounding_tile{dir = 8},/obj/structure/stone_tile/surrounding_tile{dir = 4},/obj/structure/stone_tile/surrounding_tile,/obj/structure/stone_tile/center,/turf/open/chasm/lavaland,/area/ruin/unpowered/xenonest)
"bq" = (/turf/open/chasm/lavaland,/area/ruin/unpowered/xenonest)
"br" = (/obj/structure/stone_tile/block/cracked{dir = 8},/obj/structure/stone_tile,/obj/structure/stone_tile{dir = 1},/obj/effect/decal/cleanable/blood/xeno,/turf/open/indestructible/boss,/area/ruin/unpowered/xenonest)
"bs" = (/obj/structure/stone_tile/block{dir = 8},/turf/open/chasm/lavaland,/area/ruin/unpowered/xenonest)
"bw" = (/obj/structure/stone_tile/cracked{dir = 4},/obj/structure/stone_tile/cracked,/obj/structure/stone_tile{dir = 1},/obj/structure/stone_tile{dir = 8},/obj/item/flashlight/lantern,/turf/open/indestructible/boss,/area/ruin/unpowered/xenonest)
"bx" = (/obj/structure/stone_tile/block{dir = 1},/obj/structure/stone_tile,/obj/structure/stone_tile{dir = 8},/obj/effect/decal/cleanable/blood/xeno,/turf/open/indestructible/boss,/area/ruin/unpowered/xenonest)
"by" = (/obj/structure/stone_tile/block{dir = 1},/obj/structure/stone_tile,/obj/structure/stone_tile/cracked{dir = 8},/turf/open/indestructible/boss,/area/ruin/unpowered/xenonest)
"bz" = (/obj/structure/stone_tile/block/cracked{dir = 1},/obj/structure/stone_tile/cracked,/obj/structure/stone_tile{dir = 8},/turf/open/indestructible/boss,/area/ruin/unpowered/xenonest)
"bA" = (/obj/structure/stone_tile/cracked{dir = 1},/obj/structure/stone_tile{dir = 4},/obj/structure/stone_tile{dir = 8},/obj/structure/stone_tile,/obj/item/flashlight/lantern,/turf/open/indestructible/boss,/area/ruin/unpowered/xenonest)
"bB" = (/obj/structure/alien/weeds,/obj/effect/decal/cleanable/blood/old,/turf/open/floor/plating/asteroid/basalt/lava_land_surface,/area/ruin/unpowered/xenonest)
"bC" = (/obj/structure/alien/weeds,/obj/structure/bed/nest,/mob/living/simple_animal/hostile/alien,/turf/open/floor/plating/asteroid/basalt/lava_land_surface,/area/ruin/unpowered/xenonest)
"bD" = (/obj/structure/alien/weeds,/turf/template_noop,/area/ruin/unpowered/xenonest)
"dE" = (/obj/structure/alien/weeds,/obj/structure/bed/nest,/obj/item/healthanalyzer,/obj/item/clothing/suit/bio_suit/scientist,/obj/item/reagent_containers/hypospray/medipen,/obj/item/clothing/mask/facehugger/impregnated,/turf/open/floor/plating/asteroid/basalt/lava_land_surface,/area/ruin/unpowered/xenonest)
"iA" = (/obj/structure/alien/weeds,/obj/structure/bed/nest,/obj/item/clothing/head/welding,/obj/item/weldingtool/largetank,/obj/item/clothing/mask/facehugger/impregnated,/turf/open/floor/plating/asteroid/basalt/lava_land_surface,/area/ruin/unpowered/xenonest)
"lG" = (/obj/structure/alien/weeds,/obj/effect/mob_spawn/alien/corpse/humanoid/drone,/turf/open/floor/plating/asteroid/basalt/lava_land_surface,/area/ruin/unpowered/xenonest)
"wA" = (/obj/structure/alien/weeds,/obj/structure/alien/weeds/node,/turf/open/floor/plating/asteroid/basalt/lava_land_surface,/area/ruin/unpowered/xenonest)
"yf" = (/obj/structure/alien/weeds/node,/mob/living/simple_animal/hostile/alien/sentinel,/turf/open/floor/plating/asteroid/basalt/lava_land_surface,/area/ruin/unpowered/xenonest)
"Dd" = (/obj/structure/alien/weeds,/obj/effect/decal/cleanable/blood/gibs,/obj/item/storage/backpack/duffelbag/sec/surgery,/turf/open/floor/plating/asteroid/basalt/lava_land_surface,/area/ruin/unpowered/xenonest)
"JM" = (/obj/structure/alien/weeds/node,/obj/effect/mob_spawn/alien/corpse/humanoid/drone,/turf/open/floor/plating/asteroid/basalt/lava_land_surface,/area/ruin/unpowered/xenonest)
"QG" = (/obj/structure/alien/weeds,/obj/structure/bed/nest,/obj/structure/alien/weeds/node,/turf/open/floor/plating/asteroid/basalt/lava_land_surface,/area/ruin/unpowered/xenonest)
"Uh" = (/obj/structure/alien/weeds,/obj/item/xenos_claw,/turf/open/floor/plating/asteroid/basalt/lava_land_surface,/area/ruin/unpowered/xenonest)
"Vi" = (/obj/structure/bed/nest,/obj/structure/alien/weeds,/obj/item/clothing/suit/space/hardsuit/mining,/obj/item/clothing/gloves/color/black,/obj/item/radio/headset/headset_cargo/mining,/obj/item/clothing/mask/facehugger/impregnated,/turf/open/floor/plating/asteroid/basalt/lava_land_surface,/area/ruin/unpowered/xenonest)
"VZ" = (/obj/structure/alien/weeds,/obj/effect/gibspawner/human,/turf/open/floor/plating/asteroid/basalt/lava_land_surface,/area/ruin/unpowered/xenonest)
"ZT" = (/obj/effect/mob_spawn/human/corpse/syndicatesoldier,/turf/open/floor/plating/asteroid/basalt/lava_land_surface,/area/ruin/unpowered/xenonest)

(1,1,1) = {"
aaababababababababaaaaaaaaababababababababababababababaa
ababacacacacacacababababababacacacacacacacacacacacacabab
abacacadaeafwAacacababababacacafafacahacahacahacagacacab
abacajadakakagamacanababacacagagagagafahaoapaqagagafacab
abacacafaragagacacananabacafagaragacahacahacahacJMagasab
abacQGagaglGagafacacanabacagatlGagakJMahacaharakagafatab
abacacakauacaFaramacananacafagagafacViagaiafahacagagatab
ababacagagacagagacacananacawacagacacakacwAacakacacaFacab
aaabacagagagagacacanananacaFagwAagagagaFagatagataOagacab
aaabacacavaragacananananacamatadafatagagagagatagaragacab
aaababacacagacacacanananacacacagaoaQataragagagavagawacab
aaababacagagacamacacananananacagaBatagagagagagagagamacab
aaabacacagaAagaFagacananananacagagagagagatagawacacacacab
ababacagagagacagaracacacananacacagawagaragagafacabababab
abacacafaracacagagagagacanananacacacafagaCagacacabaaaaaa
abacaUagagacacacagagacacacananananacacakakacacababaaaaaa
abacakaEacacanacacagacaFacagacanananacararacababaaaaaaaa
abacagagacanananacagaragaGagacacacacacagagacababaaaaaaaa
abacaraFacanananacacacagagagaragagakyfagagacacabaaaaaaaa
abacaHacacacananananacaciAakafaIadagagagagagacabaaaaaaaa
abacaJagwAacanananananacacacacamacacacagagagacababaaaaaa
agacacagagacacanananananananacacacanacacagaracacabaaaaaa
ababacaLagaMagananananananananananananacakagagacababaaaa
ababacagaragacanananacacacacacacanananacaPagagacacabaaaa
abacacagagacacananacacamacDdaVacanananacacaTagaFacababaa
abacaSVZafacanananacamagaJagacacanananacamafaragacacabaa
abacakagacacananacacacarafakacananananacacacagaXagacabaa
abacamagacanananacbiacagagaOacananananananaWacagUhacabaa
abacakagacacacanacaxaJagacafacacanananabababacagwAacabab
abacamaragalacanacacakagacacavacacanababaZaZaZbaaZaZaZab
abacacagagacacananacafagaragagafacacababaZbbbcbdbebfaZab
ababacafagagacananacacaFagacbgagacagacacaZbhbjbkboblaZab
aaabacacagagacacananacacacacacagaraXagagayazbqbqbsbraZab
aaababacagaoZTacananananananacacacacacacaZbnaDbqaKaNaZab
aaaaabacagagacacacacacacananananananababaZbwbxbybzbAaZab
aaaaabacacagwAagacagagacacacananananababaZaZaZaZaZaZaZab
aaaaababacacagagaragagagagacacananananababababababababab
aaaaaaababacacacacacagagaragacanacacacacacacacababababaa
aaaaaaaaabababababacacacagagacacacagaragagagacacababaaaa
aaaaaaaaaaaaaaaaabababacagagagaragagbBagagagagacaaaaaaaa
aaaaaaaaaaaaaaaaaaaaabacacdEacbCakamacacagaragacaaaaaaaa
aaaaaaaaaaaaaaaaaaaaababacacacacacacacacacagagacacaaaaaa
aaaaaaaaaaaaaaaaaaaaaaaaaaaaaaaaaaaaaaaaacafagwAacaaaaaa
aaaaaaaaaaaaaaaaaaaaaaaaaaaaaaaaaaaaaaaaacacagagacaaaaaa
aaaaaaaaaaaaaaaaaaaaaaaaaaaaaaaaaaaaaaaaaaacawawacaaaaaa
aaaaaaaaaaaaaaaaaaaaaaaaaaaaaaaaaaaaacaaaaacararacaaaaaa
aaaaaaaaaaaaaaaaaaaaaaaaaaaaaaaaaaaabDacacaWagagacacaaaa
aaaaaaaaaaaaaaaaaaaaaaaaaaaaaaaaaaaabDbDbDbDbDbDbDacaaaa
aaaaaaaaaaaaaaaaaaaaaaaaaaaaaaaaaaaaaaaabDbDbDbDbDacaaaa
"}
