"aa" = (/turf/template_noop,/area/template_noop)
"ab" = (/turf/closed/wall/r_wall{baseturf = /turf/open/floor/plating/lava/smooth},/area/ruin/powered)
"ac" = (/turf/closed/wall/r_wall,/area/ruin/powered)
"ad" = (/obj/structure/flora/ausbushes/leafybush,/turf/open/floor/plating/beach/sand,/area/ruin/powered)
"ae" = (/obj/structure/table,/obj/item/weapon/storage/toolbox/mechanical,/obj/item/stack/cable_coil,/turf/open/floor/plating{baseturf = /turf/open/floor/plating/lava/smooth},/area/ruin/powered)
"af" = (/obj/structure/table,/obj/item/clothing/mask/gas,/turf/open/floor/plating{baseturf = /turf/open/floor/plating/lava/smooth},/area/ruin/powered)
"ag" = (/obj/structure/reagent_dispensers/fueltank,/turf/open/floor/plating{baseturf = /turf/open/floor/plating/lava/smooth},/area/ruin/powered)
"ah" = (/obj/machinery/power/smes,/turf/open/floor/plating{baseturf = /turf/open/floor/plating/lava/smooth},/area/ruin/powered)
"ai" = (/obj/machinery/portable_atmospherics/canister/oxygen,/turf/open/floor/plating{baseturf = /turf/open/floor/plating/lava/smooth},/area/ruin/powered)
"aj" = (/turf/closed/wall/mineral/sandstone{baseturf = /turf/open/floor/plating/beach/sand},/area/ruin/powered)
"ak" = (/obj/structure/toilet,/obj/effect/decal/sandeffect,/turf/open/floor/plating{baseturf = /turf/open/floor/plating/lava/smooth},/area/ruin/powered)
"al" = (/obj/structure/urinal{pixel_y = 32},/turf/open/floor/plating{baseturf = /turf/open/floor/plating/lava/smooth},/area/ruin/powered)
"am" = (/obj/structure/urinal{pixel_y = 32},/obj/effect/decal/sandeffect,/turf/open/floor/plating{baseturf = /turf/open/floor/plating/lava/smooth},/area/ruin/powered)
"an" = (/obj/item/device/flashlight/lantern,/turf/open/floor/plating{baseturf = /turf/open/floor/plating/lava/smooth},/area/ruin/powered)
"ao" = (/obj/structure/sink{dir = 4; icon_state = "sink"; pixel_x = 11; pixel_y = 0},/obj/effect/decal/sandeffect,/obj/structure/mirror{pixel_x = 28},/turf/open/floor/plating{baseturf = /turf/open/floor/plating/lava/smooth},/area/ruin/powered)
"ap" = (/obj/structure/flora/ausbushes/sparsegrass,/turf/open/floor/plating/beach/sand,/area/ruin/powered)
"aq" = (/obj/structure/flora/ausbushes/sunnybush,/turf/open/floor/plating/beach/sand,/area/ruin/powered)
"ar" = (/turf/open/floor/plating/beach/sand,/area/ruin/powered)
"as" = (/turf/open/floor/plating{baseturf = /turf/open/floor/plating/lava/smooth},/area/ruin/powered)
"at" = (/obj/item/weapon/tank/internals/oxygen,/turf/open/floor/plating{baseturf = /turf/open/floor/plating/lava/smooth},/area/ruin/powered)
"au" = (/obj/effect/decal/sandeffect,/turf/open/floor/plating{baseturf = /turf/open/floor/plating/lava/smooth},/area/ruin/powered)
"av" = (/obj/machinery/door/airlock/hatch,/turf/open/floor/plating{baseturf = /turf/open/floor/plating/lava/smooth},/area/ruin/powered)
"aw" = (/obj/machinery/door/airlock/sandstone,/turf/open/floor/wood,/area/ruin/powered)
"ax" = (/obj/structure/extinguisher_cabinet,/turf/closed/wall/mineral/sandstone{baseturf = /turf/open/floor/plating/beach/sand},/area/ruin/powered)
"ay" = (/obj/machinery/door/airlock/hatch,/obj/effect/decal/sandeffect,/turf/open/floor/plating{baseturf = /turf/open/floor/plating/lava/smooth},/area/ruin/powered)
"az" = (/obj/item/clothing/tie/dope_necklace,/obj/item/weapon/reagent_containers/spray/spraytan,/turf/open/floor/plating/beach/sand,/area/ruin/powered)
"aA" = (/obj/effect/decal/sandeffect,/turf/open/floor/plating/beach/sand,/area/ruin/powered)
"aB" = (/turf/open/floor/plasteel/asteroid/warning{baseturf = /turf/open/floor/plating/beach/sand; dir = 1; tag = "icon-asteroidwarning (NORTH)"},/area/ruin/powered)
"aC" = (/turf/open/floor/wood,/area/ruin/powered)
"aD" = (/obj/structure/table,/obj/item/weapon/storage/box/drinkingglasses,/obj/item/weapon/storage/box/drinkingglasses,/obj/item/weapon/reagent_containers/food/drinks/shaker,/obj/item/weapon/storage/box/beakers,/turf/open/floor/wood,/area/ruin/powered)
"aE" = (/obj/structure/table,/obj/machinery/reagentgrinder,/turf/open/floor/wood,/area/ruin/powered)
"aF" = (/obj/machinery/vending/boozeomat{emagged = 1},/turf/open/floor/wood,/area/ruin/powered)
"aG" = (/obj/structure/table,/obj/item/weapon/book/manual/barman_recipes,/obj/item/weapon/reagent_containers/glass/rag,/turf/open/floor/wood,/area/ruin/powered)
"aH" = (/obj/structure/table,/obj/item/weapon/storage/box/donkpockets,/turf/open/floor/wood,/area/ruin/powered)
"aI" = (/obj/structure/table,/obj/machinery/microwave,/turf/open/floor/wood,/area/ruin/powered)
"aJ" = (/obj/structure/closet/crate/bin,/obj/item/weapon/tank/internals/emergency_oxygen,/obj/item/trash/candy,/obj/item/toy/talking/owl,/turf/open/floor/plasteel/asteroid/warning{baseturf = /turf/open/floor/plating/beach/sand; dir = 1; tag = "icon-asteroidwarning (NORTH)"},/area/ruin/powered)
"aK" = (/turf/open/floor/plasteel/asteroid{baseturf = /turf/open/floor/plating/beach/sand},/area/ruin/powered)
"aL" = (/obj/effect/mob_spawn/human/bartender/alive{name = "beach bum sleeper"},/turf/open/floor/wood,/area/ruin/powered)
"aM" = (/obj/structure/reagent_dispensers/beerkeg,/turf/open/floor/wood,/area/ruin/powered)
"aN" = (/obj/machinery/vending/cigarette,/turf/open/floor/plasteel/asteroid{baseturf = /turf/open/floor/plating/beach/sand},/area/ruin/powered)
"aO" = (/obj/structure/stacklifter,/turf/open/floor/plating/beach/sand,/area/ruin/powered)
"aP" = (/obj/structure/table/wood,/turf/open/floor/wood,/area/ruin/powered)
"aQ" = (/obj/structure/table/wood,/obj/item/device/flashlight/lamp,/turf/open/floor/wood,/area/ruin/powered)
"aR" = (/obj/structure/table/wood,/obj/item/weapon/reagent_containers/food/drinks/bottle/tequila,/turf/open/floor/wood,/area/ruin/powered)
"aS" = (/obj/machinery/processor,/turf/open/floor/wood,/area/ruin/powered)
"aT" = (/obj/machinery/vending/cola,/turf/open/floor/plasteel/asteroid{baseturf = /turf/open/floor/plating/beach/sand},/area/ruin/powered)
"aU" = (/obj/effect/overlay/palmtree_l,/turf/open/floor/plating/beach/sand,/area/ruin/powered)
"aV" = (/obj/effect/mob_spawn/human/beach/alive{flavour_text = "You're, like, totally a dudebro, bruh. Ch'yea. You came here, like, on spring break, hopin' to pick up some bangin' hot chicks, y'knaw?"; pocket2 = /obj/item/weapon/reagent_containers/food/snacks/pizzaslice/dank; uniform = /obj/item/clothing/under/pants/youngfolksjeans},/turf/open/floor/plating/beach/sand,/area/ruin/powered)
"aW" = (/obj/structure/chair/stool,/turf/open/floor/plasteel/asteroid/warning{baseturf = /turf/open/floor/plating/beach/sand; dir = 1; tag = "icon-asteroidwarning (NORTH)"},/area/ruin/powered)
"aX" = (/obj/structure/closet/secure_closet/freezer/meat,/turf/open/floor/wood,/area/ruin/powered)
"aY" = (/obj/machinery/vending/snack,/turf/open/floor/plasteel/asteroid{baseturf = /turf/open/floor/plating/beach/sand},/area/ruin/powered)
"aZ" = (/obj/effect/overlay/coconut,/turf/open/floor/plating/beach/sand,/area/ruin/powered)
"ba" = (/obj/machinery/light{dir = 4; icon_state = "tube1"},/turf/template_noop,/area/ruin/powered)
"bb" = (/obj/structure/weightlifter,/turf/open/floor/plating/beach/sand,/area/ruin/powered)
"bc" = (/obj/machinery/door/airlock/sandstone,/obj/effect/decal/sandeffect,/turf/open/floor/wood,/area/ruin/powered)
"bd" = (/obj/structure/closet/secure_closet/freezer/kitchen,/turf/open/floor/wood,/area/ruin/powered)
"be" = (/obj/vehicle/scooter/skateboard{dir = 4},/turf/open/floor/plating/beach/sand,/area/ruin/powered)
"bf" = (/obj/machinery/light{icon_state = "tube1"; dir = 8},/turf/template_noop,/area/ruin/powered)
"bg" = (/obj/structure/sign/barsign,/turf/closed/wall/mineral/sandstone,/area/ruin/powered)
"bh" = (/turf/closed/wall/mineral/sandstone,/area/ruin/powered)
"bi" = (/obj/structure/chair/wood/normal{icon_state = "wooden_chair"; dir = 4},/turf/open/floor/plasteel/asteroid{baseturf = /turf/open/floor/plating/beach/sand},/area/ruin/powered)
"bj" = (/obj/structure/table/wood,/obj/item/weapon/reagent_containers/food/snacks/pastatomato,/turf/open/floor/plasteel/asteroid{baseturf = /turf/open/floor/plating/beach/sand},/area/ruin/powered)
"bk" = (/obj/structure/chair/wood/normal{icon_state = "wooden_chair"; dir = 8},/turf/open/floor/plasteel/asteroid{baseturf = /turf/open/floor/plating/beach/sand},/area/ruin/powered)
"bl" = (/mob/living/simple_animal/crab,/turf/open/floor/plating/beach/sand,/area/ruin/powered)
"bm" = (/obj/structure/closet/athletic_mixed,/turf/open/floor/pod/dark{baseturf = /turf/open/floor/plating/asteroid/basalt},/area/ruin/powered)
"bn" = (/obj/structure/rack,/obj/item/clothing/shoes/sandal,/obj/item/clothing/shoes/sandal,/obj/effect/decal/sandeffect,/turf/open/floor/pod/dark{baseturf = /turf/open/floor/plating/asteroid/basalt},/area/ruin/powered)
"bo" = (/obj/structure/grille,/obj/structure/window/fulltile,/turf/open/floor/plating{baseturf = /turf/open/floor/plating/lava/smooth},/area/ruin/powered)
"bp" = (/obj/structure/closet/athletic_mixed,/obj/effect/decal/sandeffect,/turf/open/floor/pod/dark{baseturf = /turf/open/floor/plating/asteroid/basalt},/area/ruin/powered)
"bq" = (/turf/open/floor/pod/dark{baseturf = /turf/open/floor/plating/asteroid/basalt},/area/ruin/powered)
"br" = (/obj/effect/decal/sandeffect,/turf/open/floor/pod/dark{baseturf = /turf/open/floor/plating/asteroid/basalt},/area/ruin/powered)
"bs" = (/obj/machinery/door/airlock/hatch,/obj/structure/fans/tiny,/turf/open/floor/pod/dark{baseturf = /turf/open/floor/plating/asteroid/basalt},/area/ruin/powered)
"bt" = (/turf/open/floor/pod/light{baseturf = /turf/open/floor/plating/lava/smooth},/area/ruin/powered)
"bu" = (/obj/effect/decal/sandeffect,/turf/open/floor/pod/light{baseturf = /turf/open/floor/plating/lava/smooth},/area/ruin/powered)
"bv" = (/obj/machinery/door/airlock/sandstone,/turf/open/floor/pod/dark{baseturf = /turf/open/floor/plating/asteroid/basalt},/area/ruin/powered)
"bw" = (/obj/structure/flora/rock,/turf/open/floor/plating/beach/sand,/area/ruin/powered)
"bx" = (/obj/machinery/door/airlock/sandstone,/obj/effect/decal/sandeffect,/turf/open/floor/pod/dark{baseturf = /turf/open/floor/plating/asteroid/basalt},/area/ruin/powered)
"by" = (/obj/structure/window/reinforced{dir = 1},/obj/structure/window/reinforced{dir = 8},/obj/item/weapon/bikehorn/airhorn,/obj/structure/table/wood,/obj/item/weapon/storage/firstaid,/obj/item/weapon/storage/firstaid/brute,/turf/open/floor/wood,/area/ruin/powered)
"bz" = (/obj/structure/window/reinforced{dir = 4; pixel_x = 0},/obj/structure/window/reinforced{dir = 1; layer = 2.9},/obj/structure/chair/stool,/turf/open/floor/wood,/area/ruin/powered)
"bA" = (/obj/structure/table/wood,/obj/item/weapon/tank/internals/oxygen,/obj/item/weapon/pickaxe,/obj/item/clothing/mask/gas,/turf/open/floor/pod/dark{baseturf = /turf/open/floor/plating/asteroid/basalt},/area/ruin/powered)
"bB" = (/obj/structure/dresser,/turf/open/floor/pod/dark{baseturf = /turf/open/floor/plating/asteroid/basalt},/area/ruin/powered)
"bC" = (/obj/item/weapon/reagent_containers/spray/spraytan,/turf/open/floor/plating/beach/sand,/area/ruin/powered)
"bD" = (/obj/item/toy/beach_ball,/turf/open/floor/plating/beach/sand,/area/ruin/powered)
"bE" = (/obj/structure/window/reinforced{dir = 8},/obj/structure/window/reinforced,/obj/item/device/megaphone,/turf/open/floor/wood,/area/ruin/powered)
"bF" = (/obj/structure/window/reinforced{dir = 4; pixel_x = 0},/obj/effect/mob_spawn/human/beach/alive{flavour_text = "You're a spunky lifeguard! It's up to you to make sure nobody drowns or gets eaten by sharks and stuff."; has_id = 1; id_access = "Medical Doctor"; id_job = "Lifeguard"; mob_gender = "female"},/turf/open/floor/wood,/area/ruin/powered)
"bG" = (/obj/structure/chair,/turf/open/floor/plating/beach/sand,/area/ruin/powered)
"bH" = (/obj/item/weapon/storage/backpack/dufflebag,/turf/open/floor/plating/beach/sand,/area/ruin/powered)
"bI" = (/obj/effect/decal/sandeffect{density = 1},/obj/effect/decal/fakelattice,/turf/open/floor/pod/light{baseturf = /turf/open/floor/plating/lava/smooth; density = 1},/area/ruin/powered)
"bJ" = (/turf/open/floor/plasteel/stairs/old,/area/ruin/powered)
"bK" = (/obj/structure/flora/ausbushes/reedbush,/turf/open/floor/plating/beach/sand,/area/ruin/powered)
"bL" = (/obj/item/device/camera,/turf/open/floor/plating/beach/sand,/area/ruin/powered)
"bM" = (/obj/item/weapon/reagent_containers/food/drinks/beer,/turf/open/floor/plating/beach/sand,/area/ruin/powered)
"bN" = (/obj/structure/flora/ausbushes/reedbush,/turf/open/floor/plating/beach/coastline_t,/area/ruin/powered)
"bO" = (/turf/open/floor/plating/beach/coastline_t,/area/ruin/powered)
"bP" = (/obj/structure/flora/ausbushes/sparsegrass,/turf/open/floor/plating/beach/coastline_t,/area/ruin/powered)
"bQ" = (/turf/open/floor/plating/beach/coastline_b,/area/ruin/powered)
"bR" = (/turf/open/floor/plating/beach/water,/area/ruin/powered)
"bS" = (/obj/structure/flora/ausbushes/stalkybush,/turf/open/floor/plating/beach/water,/area/ruin/powered)

(1,1,1) = {"
aaaaaaaaaaaaaaaaaaaaaaaaaaaaaaaaaaaaaaaaaaaaaaaaaaaaaaaaaaaa
aaaaaaaaaaaaabababacacacacacacacacacacacacabababaaaaaaaaaaaa
aaaaaaaaabababadabaeafagahaiajakajalamanaoabapabababaaaaaaaa
aaaaaaababaqararabasasasasatajauavasasauauabararaqababaaaaaa
aaaaababadaraparababajawajaxajajajajajajayabaraparapababaaaa
aaaaabapararazaraAaBajaCaDaEaFaGaHaIajaJaKaAararararadabaaaa
aaababarararararaAaKajaCaCaLaCaCaCaMajaNaKaAarararararababaa
aaabaparaOaraOaraAaKajaPaQaPaRajaCaSajaTaKaAaraUaraqarapabaa
aaabarararaVararaAaKaBaWaWaWaWajaCaXajaYaKaAararaZarararabaa
baabararbbarbbaraAaKaKaKaKaKaKbcaCbdajaKaKaAarararbearapabbf
aaabararararararaAaKaKaKaKaKaKajbgbhajaKaKaAararararararabaa
ababababararararaAaKbibjbkaKaKaBaBaBaBaKaKaAarblararabababab
acbmbnboararararaAaKaKaKaKaKaKaKaKaKaKaKaKaAararararbobpbnab
acbqbqboararaUaraAaAaAaAaAaAaAaAaAaAaAaAaAaAararararbobqbrab
bsbtbuboaAaraZararararararararararararararararararaAbobtbtbs
abbububvaAarararararararbwaparararaZarararararararaAbxbubtab
bsbtbtboaAararararaparapararararaUararararararararaAbobububs
acbrbqboarblararapbwarararararararararbybzararaZararbobrbqab
acbAbBboararararararararararbCararbDarbEbFarararararbobBbAab
ababababarbGarbGarbGarbGbHbGarbGarararbIbJarbGararaUabababab
aaabadapbKararbCbLararararararararblarararbMararararapbKabaa
baabbNbObObPbObObObObObObObObObObObObObObObObObObPbObObOabbf
aaabbQbQbQbQbQbQbQbQbQbQbQbQbQbQbQbQbQbQbQbQbQbQbQbQbQbQabaa
aaababbRbRbRbRbRbRbRbRbRbRbRbRbRbRbRbRbRbRbRbRbRbRbRbRababaa
aaaaabbRbRbRbRbRbRbRbRbRbRbRbRbRbSbRbRbRbRbRbRbRbRbRbRabaaaa
aaaaababbRbRbRbRbRbSbRbRbRbRbRbRbRbRbRbRbRbRbRbRbRbRababaaaa
aaaaaaababbRbRbRbRbRbRbRbRbRbRbRbRbRbRbRbRbSbRbRbRababaaaaaa
aaaaaaaaabababbRbRbRbRbRbRbRbRbRbRbRbRbRbRbRbRabababaaaaaaaa
aaaaaaaaaaaaababababababababababababababababababaaaaaaaaaaaa
aaaaaaaaaaaaababababababababababababababababababaaaaaaaaaaaa
"}
