//MAP CONVERTED BY dmm2tgm.py THIS HEADER COMMENT PREVENTS RECONVERSION, DO NOT REMOVE
"a" = (
/turf/open/floor/plating/asteroid/basalt/lava_land_surface,
/area/lavaland/surface)
"b" = (
/turf/closed/mineral/volcanic/lava_land_surface,
/area/lavaland/surface/outdoors)
"e" = (
/obj/structure/spawner/nether,
/turf/open/floor/plating/asteroid/basalt/lava_land_surface,
/area/lavaland/surface)
"q" = (
/turf/closed/mineral/strong/wasteland,
/area/lavaland/surface/outdoors)

(1,1,1) = {"
b
b
b
b
b
b
b
b
b
b
b
b
b
b
b
"}
(2,1,1) = {"
b
b
b
b
q
q
q
q
q
q
q
b
b
b
b
"}
(3,1,1) = {"
b
b
q
q
q
a
a
a
a
a
q
q
q
b
b
"}
(4,1,1) = {"
b
b
q
a
a
a
a
a
a
a
a
a
q
b
b
"}
(5,1,1) = {"
b
q
q
a
a
a
a
a
a
a
a
a
q
q
b
"}
(6,1,1) = {"
b
q
a
a
a
a
a
a
a
a
a
a
a
q
b
"}
(7,1,1) = {"
b
q
a
a
a
a
a
a
a
a
a
a
a
q
b
"}
(8,1,1) = {"
b
q
a
a
a
a
a
e
a
a
a
a
a
q
b
"}
(9,1,1) = {"
b
q
a
a
a
a
a
a
a
a
a
a
a
q
b
"}
(10,1,1) = {"
b
q
a
a
a
a
a
a
a
a
a
a
a
q
b
"}
(11,1,1) = {"
b
q
q
a
a
a
a
a
a
a
a
a
q
q
b
"}
(12,1,1) = {"
b
b
q
a
a
a
a
a
a
a
a
a
q
b
b
"}
(13,1,1) = {"
b
b
q
q
q
a
a
a
a
a
q
q
q
b
b
"}
(14,1,1) = {"
b
b
b
b
q
q
q
q
q
q
q
b
b
b
b
"}
(15,1,1) = {"
b
b
b
b
b
b
b
b
b
b
b
b
b
b
b
"}
