//MAP CONVERTED BY dmm2tgm.py THIS HEADER COMMENT PREVENTS RECONVERSION, DO NOT REMOVE
"a" = (
/turf/open/floor/plating/asteroid/basalt/lava_land_surface,
/area/lavaland/surface/outdoors/unexplored/danger)
"c" = (
/obj/structure/ladder,
/turf/open/floor/plating/asteroid/basalt/lava_land_surface,
/area/lavaland/surface/outdoors/unexplored/danger)
"d" = (
/turf/template_noop,
/area/template_noop)
"f" = (
/obj/item/flashlight/lantern{
	on = 1
	},
/turf/open/floor/plating/asteroid/basalt/lava_land_surface,
/area/lavaland/surface/outdoors/unexplored/danger)
"g" = (
/obj/item/clothing/suit/hooded/explorer,
/obj/effect/decal/cleanable/blood/gibs/up,
/turf/open/floor/plating/asteroid/basalt/lava_land_surface,
/area/lavaland/surface/outdoors/unexplored/danger)
"h" = (
/obj/item/clothing/shoes/jackboots,
/turf/open/floor/plating/asteroid/basalt/lava_land_surface,
/area/lavaland/surface/outdoors/unexplored/danger)
"i" = (
/obj/item/kitchen/knife/combat/survival,
/turf/open/floor/plating/asteroid/basalt/lava_land_surface,
/area/lavaland/surface/outdoors/unexplored/danger)
"R" = (
/mob/living/simple_animal/hostile/megafauna/blood_drunk_miner/hunter{
	dir = 4
	},
/turf/open/floor/plating/asteroid/basalt/lava_land_surface,
/area/lavaland/surface/outdoors/unexplored/danger)
"T" = (
/turf/closed/mineral/volcanic,
/area/lavaland/surface/outdoors/unexplored/danger)

(1,1,1) = {"
d
d
d
d
d
d
d
d
d
d
d
d
d
d
d
d
d
d
d
d
d
d
d
d
d
"}
(2,1,1) = {"
d
d
d
d
d
d
d
T
T
T
T
T
T
T
T
T
T
T
d
d
d
d
d
d
d
"}
(3,1,1) = {"
d
d
d
d
d
T
T
T
a
a
a
a
a
a
a
a
a
T
T
d
d
d
d
d
d
"}
(4,1,1) = {"
d
d
d
d
T
T
a
a
a
a
a
a
a
a
a
a
a
a
T
T
d
d
d
d
d
"}
(5,1,1) = {"
d
d
d
T
T
a
a
a
a
a
a
a
a
a
a
a
a
a
a
T
T
d
d
d
d
"}
(6,1,1) = {"
d
d
T
T
a
a
a
a
a
a
a
a
a
a
a
a
a
a
a
a
T
T
d
d
d
"}
(7,1,1) = {"
d
d
T
a
a
a
a
a
a
a
a
a
a
a
a
a
a
a
a
a
a
T
T
d
d
"}
(8,1,1) = {"
d
T
T
a
a
a
a
a
a
a
a
a
a
a
a
a
a
a
a
a
a
a
T
d
d
"}
(9,1,1) = {"
d
T
a
a
a
a
a
a
a
a
a
a
a
a
a
a
a
a
a
a
a
a
T
T
d
"}
(10,1,1) = {"
d
T
a
a
a
a
a
R
a
a
a
a
a
a
a
a
a
a
a
a
a
a
a
T
d
"}
(11,1,1) = {"
d
T
a
a
a
a
a
a
a
a
a
a
a
a
a
a
a
a
a
a
a
a
a
T
d
"}
(12,1,1) = {"
d
T
a
a
a
a
a
a
a
a
a
a
a
a
a
a
a
a
a
a
a
a
a
T
d
"}
(13,1,1) = {"
d
T
a
a
a
a
a
a
a
a
a
a
a
a
a
a
a
a
a
a
a
a
a
T
d
"}
(14,1,1) = {"
d
T
a
a
a
a
a
a
a
a
a
a
a
a
a
a
a
a
a
a
a
a
a
T
d
"}
(15,1,1) = {"
d
T
a
a
a
a
a
a
a
a
a
a
a
a
a
a
a
a
a
a
a
a
a
T
d
"}
(16,1,1) = {"
d
T
a
a
a
a
a
a
a
a
a
a
a
a
a
a
a
a
a
a
a
a
a
T
d
"}
(17,1,1) = {"
d
T
a
a
a
a
a
a
a
a
a
a
a
a
a
a
a
a
a
a
a
a
a
T
d
"}
(18,1,1) = {"
d
T
a
a
a
a
a
a
a
a
a
a
a
a
c
a
a
a
a
a
a
a
a
T
d
"}
(19,1,1) = {"
d
T
a
a
a
a
a
a
a
a
a
a
a
a
a
a
a
a
a
a
a
a
a
T
d
"}
(20,1,1) = {"
d
T
a
a
a
a
a
a
a
a
a
a
a
a
a
a
a
a
a
a
a
a
a
T
d
"}
(21,1,1) = {"
d
T
a
a
a
a
a
a
a
a
a
a
a
a
a
a
a
a
a
a
a
a
a
T
d
"}
(22,1,1) = {"
d
T
a
a
a
a
a
a
a
a
a
a
a
a
a
a
a
a
a
a
a
a
T
T
d
"}
(23,1,1) = {"
d
T
T
a
a
a
a
a
a
a
a
a
a
a
a
a
a
a
a
a
a
T
T
d
d
"}
(24,1,1) = {"
d
d
T
T
a
a
f
i
a
a
a
a
a
a
a
a
a
a
a
a
T
T
d
d
d
"}
(25,1,1) = {"
d
d
d
T
T
a
a
g
a
a
a
a
a
a
a
a
a
a
a
T
T
d
d
d
d
"}
(26,1,1) = {"
d
d
d
d
T
T
a
h
a
a
a
a
a
a
a
a
a
a
T
T
d
d
d
d
d
"}
(27,1,1) = {"
d
d
d
d
d
T
T
T
a
a
a
a
a
a
a
a
a
T
T
d
d
d
d
d
d
"}
(28,1,1) = {"
d
d
d
d
d
d
d
T
T
T
T
T
T
T
T
T
T
T
d
d
d
d
d
d
d
"}
(29,1,1) = {"
d
d
d
d
d
d
d
d
d
d
d
d
d
d
d
d
d
d
d
d
d
d
d
d
d
"}
