//MAP CONVERTED BY dmm2tgm.py THIS HEADER COMMENT PREVENTS RECONVERSION, DO NOT REMOVE
"a" = (
/turf/closed/mineral/random/volcanic,
/area/icemoon/surface/outdoors/unexplored)
"b" = (
/turf/closed/mineral/random/snow,
/area/icemoon/underground/explored)
"y" = (
/mob/living/simple_animal/hostile/megafauna/dragon{
	desc = "Hunted to extinction, the icey moon of lavaland is the final resting place for these creatures.";
	name = "the last ash drake"
	},
/turf/open/floor/mineral/gold,
/area/icemoon/underground/explored)
"B" = (
/turf/closed/mineral/random,
/area/icemoon/surface/outdoors/unexplored)
"P" = (
/turf/open/floor/mineral/silver,
/area/icemoon/underground/explored)
"R" = (
/turf/open/floor/mineral/gold,
/area/icemoon/underground/explored)
"T" = (
/turf/closed/mineral/random,
/area/icemoon/underground/explored)

(1,1,1) = {"
b
b
b
b
b
b
b
b
b
b
b
b
b
b
b
b
b
b
b
b
b
b
b
b
b
b
b
b
b
b
b
b
b
b
b
b
b
b
b
b
"}
(2,1,1) = {"
b
b
b
b
b
b
b
b
b
b
b
b
b
b
b
b
b
b
b
b
b
b
b
b
b
b
b
b
b
b
b
b
b
b
b
b
b
b
b
b
"}
(3,1,1) = {"
b
b
b
B
B
B
B
B
B
B
B
B
B
B
B
B
B
B
B
B
B
B
B
B
B
B
B
B
B
B
B
B
B
B
B
B
B
b
b
b
"}
(4,1,1) = {"
b
b
B
B
B
B
B
B
B
B
B
B
B
B
B
B
B
B
B
B
B
B
B
B
B
B
B
B
B
B
B
B
B
B
B
B
B
B
b
b
"}
(5,1,1) = {"
b
b
B
B
B
B
B
B
B
B
B
B
B
B
B
B
B
B
B
B
B
B
B
B
B
B
B
B
B
B
B
B
B
B
B
B
B
B
b
b
"}
(6,1,1) = {"
b
b
B
B
B
a
a
a
a
a
a
a
a
a
a
a
a
a
a
a
a
a
a
a
a
a
a
a
a
a
a
a
a
a
B
B
B
B
b
b
"}
(7,1,1) = {"
b
b
B
B
B
a
a
a
a
a
a
a
a
a
a
a
a
a
a
a
a
a
a
a
a
a
a
a
a
a
a
a
a
a
B
B
B
B
b
b
"}
(8,1,1) = {"
b
b
B
B
B
a
a
a
a
a
a
a
a
a
a
a
a
a
a
a
a
a
a
a
a
a
a
a
a
a
a
a
a
a
B
B
B
B
b
b
"}
(9,1,1) = {"
b
b
B
B
B
a
a
a
a
a
a
a
a
a
a
a
a
a
a
a
a
a
a
a
a
a
a
a
a
a
a
a
a
a
B
B
B
B
b
b
"}
(10,1,1) = {"
b
b
B
B
B
a
a
a
a
a
a
a
a
a
a
a
a
a
a
a
a
a
a
a
a
a
a
a
a
a
a
a
a
a
B
B
B
B
b
b
"}
(11,1,1) = {"
b
b
B
B
B
a
a
a
a
a
a
a
a
a
a
a
a
a
a
a
a
a
a
a
a
a
a
a
a
a
a
a
a
a
B
B
B
B
b
b
"}
(12,1,1) = {"
b
b
B
B
B
a
a
a
a
a
a
a
a
a
a
a
a
a
a
a
a
a
a
a
a
a
a
a
a
a
a
a
a
a
B
B
B
B
b
b
"}
(13,1,1) = {"
b
b
B
B
B
a
a
a
a
a
a
a
a
a
a
a
a
a
a
a
a
a
a
a
a
a
a
a
a
a
a
a
a
a
B
B
B
B
b
b
"}
(14,1,1) = {"
b
b
B
B
B
a
a
a
a
a
a
a
a
a
a
a
a
a
a
a
a
a
a
a
a
a
a
a
a
a
a
a
a
a
B
B
B
B
b
b
"}
(15,1,1) = {"
b
b
B
B
B
a
a
a
a
a
a
a
a
a
a
a
a
a
a
a
a
a
a
a
a
a
a
a
a
a
a
a
a
a
B
B
B
B
b
b
"}
(16,1,1) = {"
b
b
B
B
B
a
a
a
a
a
a
a
a
a
a
a
a
a
a
a
a
a
a
a
a
a
a
a
a
a
a
a
a
a
B
B
B
B
b
b
"}
(17,1,1) = {"
b
b
B
B
B
a
a
a
a
a
a
a
a
a
a
a
a
a
a
a
a
a
a
a
a
a
a
a
a
a
a
a
a
a
B
B
B
B
b
b
"}
(18,1,1) = {"
b
b
B
B
B
a
a
a
a
a
a
a
a
a
a
a
a
T
T
T
T
T
T
a
a
a
a
a
a
a
a
a
a
a
B
B
B
B
b
b
"}
(19,1,1) = {"
b
b
B
B
B
a
a
a
a
a
a
a
a
a
a
a
a
T
R
P
P
R
T
a
a
a
a
a
a
a
a
a
a
a
B
B
B
B
b
b
"}
(20,1,1) = {"
b
b
B
B
B
a
a
a
a
a
a
a
a
a
a
a
a
T
P
R
R
P
T
a
a
a
a
a
a
a
a
a
a
a
B
B
B
B
b
b
"}
(21,1,1) = {"
b
b
B
B
B
a
a
a
a
a
a
a
a
a
a
a
a
T
P
R
y
P
T
a
a
a
a
a
a
a
a
a
a
a
B
B
B
B
b
b
"}
(22,1,1) = {"
b
b
B
B
B
a
a
a
a
a
a
a
a
a
a
a
a
T
R
P
P
R
T
a
a
a
a
a
a
a
a
a
a
a
B
B
B
B
b
b
"}
(23,1,1) = {"
b
b
B
B
B
a
a
a
a
a
a
a
a
a
a
a
a
T
T
T
T
T
T
a
a
a
a
a
a
a
a
a
a
a
B
B
B
B
b
b
"}
(24,1,1) = {"
b
b
B
B
B
a
a
a
a
a
a
a
a
a
a
a
a
a
a
a
a
a
a
a
a
a
a
a
a
a
a
a
a
a
B
B
B
B
b
b
"}
(25,1,1) = {"
b
b
B
B
B
a
a
a
a
a
a
a
a
a
a
a
a
a
a
a
a
a
a
a
a
a
a
a
a
a
a
a
a
a
B
B
B
B
b
b
"}
(26,1,1) = {"
b
b
B
B
B
a
a
a
a
a
a
a
a
a
a
a
a
a
a
a
a
a
a
a
a
a
a
a
a
a
a
a
a
a
B
B
B
B
b
b
"}
(27,1,1) = {"
b
b
B
B
B
a
a
a
a
a
a
a
a
a
a
a
a
a
a
a
a
a
a
a
a
a
a
a
a
a
a
a
a
a
B
B
B
B
b
b
"}
(28,1,1) = {"
b
b
B
B
B
a
a
a
a
a
a
a
a
a
a
a
a
a
a
a
a
a
a
a
a
a
a
a
a
a
a
a
a
a
B
B
B
B
b
b
"}
(29,1,1) = {"
b
b
B
B
B
a
a
a
a
a
a
a
a
a
a
a
a
a
a
a
a
a
a
a
a
a
a
a
a
a
a
a
a
a
B
B
B
B
b
b
"}
(30,1,1) = {"
b
b
B
B
B
a
a
a
a
a
a
a
a
a
a
a
a
a
a
a
a
a
a
a
a
a
a
a
a
a
a
a
a
a
B
B
B
B
b
b
"}
(31,1,1) = {"
b
b
B
B
B
a
a
a
a
a
a
a
a
a
a
a
a
a
a
a
a
a
a
a
a
a
a
a
a
a
a
a
a
a
B
B
B
B
b
b
"}
(32,1,1) = {"
b
b
B
B
B
a
a
a
a
a
a
a
a
a
a
a
a
a
a
a
a
a
a
a
a
a
a
a
a
a
a
a
a
a
B
B
B
B
b
b
"}
(33,1,1) = {"
b
b
B
B
B
a
a
a
a
a
a
a
a
a
a
a
a
a
a
a
a
a
a
a
a
a
a
a
a
a
a
a
a
a
B
B
B
B
b
b
"}
(34,1,1) = {"
b
b
B
B
B
a
a
a
a
a
a
a
a
a
a
a
a
a
a
a
a
a
a
a
a
a
a
a
a
a
a
a
a
a
B
B
B
B
b
b
"}
(35,1,1) = {"
b
b
B
B
B
a
a
a
a
a
a
a
a
a
a
a
a
a
a
a
a
a
a
a
a
a
a
a
a
a
a
a
a
a
B
B
B
B
b
b
"}
(36,1,1) = {"
b
b
B
B
B
B
B
B
B
B
B
B
B
B
B
B
B
B
B
B
B
B
B
B
B
B
B
B
B
B
B
B
B
B
B
B
B
B
b
b
"}
(37,1,1) = {"
b
b
B
B
B
B
B
B
B
B
B
B
B
B
B
B
B
B
B
B
B
B
B
B
B
B
B
B
B
B
B
B
B
B
B
B
B
B
b
b
"}
(38,1,1) = {"
b
b
b
B
B
B
B
B
B
B
B
B
B
B
B
B
B
B
B
B
B
B
B
B
B
B
B
B
B
B
B
B
B
B
B
B
B
b
b
b
"}
(39,1,1) = {"
b
b
b
b
b
b
b
b
b
b
b
b
b
b
b
b
b
b
b
b
b
b
b
b
b
b
b
b
b
b
b
b
b
b
b
b
b
b
b
b
"}
(40,1,1) = {"
b
b
b
b
b
b
b
b
b
b
b
b
b
b
b
b
b
b
b
b
b
b
b
b
b
b
b
b
b
b
b
b
b
b
b
b
b
b
b
b
"}
