//MAP CONVERTED BY dmm2tgm.py THIS HEADER COMMENT PREVENTS RECONVERSION, DO NOT REMOVE
"a" = (
/obj/structure/bed,
/obj/item/bedsheet,
/turf/open/floor/wood,
/area/ruin/space/has_grav/powered)
"c" = (
/obj/machinery/door/airlock/silver{
	name = "Bathroom"
	},
/obj/effect/turf_decal/stripes/line{
	dir = 4
	},
/turf/open/floor/plasteel/freezer,
/area/ruin/space/has_grav/powered)
"d" = (
/turf/open/floor/plating/asteroid/airless,
/area/ruin/space)
"e" = (
/obj/item/reagent_containers/glass/bottle/nutrient/ez,
/obj/item/reagent_containers/glass/bottle/nutrient/ez,
/turf/open/floor/plating/asteroid/airless,
/area/ruin/space)
"g" = (
/obj/item/reagent_containers/food/snacks/grown/mushroom/glowshroom/glowcap,
/turf/open/floor/plating/asteroid/airless,
/area/ruin/space)
"i" = (
/obj/structure/fireplace{
	dir = 8
	},
/turf/open/floor/wood,
/area/ruin/space/has_grav/powered)
"j" = (
/obj/structure/reagent_dispensers/watertank/high,
/turf/open/floor/plating/asteroid/airless,
/area/ruin/space)
"m" = (
/obj/structure/mineral_door/woodrustic{
	name = "Event Hall"
	},
/obj/structure/fans/tiny,
/turf/open/floor/wood,
/area/ruin/space/has_grav/powered)
"n" = (
/obj/machinery/vending/boozeomat{
	req_access = null
	},
/turf/open/floor/wood,
/area/ruin/space/has_grav/powered)
"o" = (
/obj/item/reagent_containers/glass/bucket,
/turf/open/floor/plating/asteroid/airless,
/area/ruin/space)
"p" = (
/turf/closed/mineral/random,
/area/ruin/space)
"q" = (
/turf/template_noop,
/area/template_noop)
"s" = (
/obj/machinery/hydroponics/soil,
/turf/open/floor/plating/asteroid/airless,
/area/ruin/space)
"t" = (
/turf/closed/indestructible/wood,
/area/ruin/space/has_grav/powered)
"v" = (
/turf/open/floor/wood,
/area/ruin/space/has_grav/powered)
"w" = (
/obj/item/plant_analyzer,
/turf/open/floor/plating/asteroid/airless,
/area/ruin/space)
"y" = (
/obj/structure/dresser,
/turf/open/floor/wood,
/area/ruin/space/has_grav/powered)
"A" = (
/obj/item/seeds/glowshroom,
/turf/open/floor/plating/asteroid/airless,
/area/ruin/space)
"C" = (
/obj/structure/chair/wood/normal{
	dir = 1
	},
/turf/open/floor/wood,
/area/ruin/space/has_grav/powered)
"E" = (
/turf/open/floor/plasteel/showroomfloor,
/area/ruin/space/has_grav/powered)
"F" = (
/obj/item/seeds/grass,
/turf/open/floor/plating/asteroid/airless,
/area/ruin/space)
"J" = (
/obj/machinery/light,
/turf/open/floor/plasteel/showroomfloor,
/area/ruin/space/has_grav/powered)
"K" = (
/obj/structure/table/wood,
/obj/machinery/light{
	dir = 4
	},
/obj/item/reagent_containers/food/drinks/bottle/wine,
/turf/open/floor/wood,
/area/ruin/space/has_grav/powered)
"L" = (
/obj/structure/mirror{
	pixel_x = 28
	},
/obj/effect/turf_decal/bot,
/obj/machinery/shower{
	dir = 8;
	pixel_y = -4
	},
/turf/open/floor/plasteel/showroomfloor,
/area/ruin/space/has_grav/powered)
"M" = (
/obj/structure/toilet{
	dir = 4
	},
/turf/open/floor/plasteel/showroomfloor,
/area/ruin/space/has_grav/powered)
"N" = (
/obj/structure/rack,
/obj/item/stack/sheet/mineral/wood,
/obj/item/stack/sheet/mineral/wood,
/turf/open/floor/wood,
/area/ruin/space/has_grav/powered)
"P" = (
/obj/structure/table/wood,
/obj/item/clothing/head/festive,
/obj/machinery/light{
	dir = 1
	},
/turf/open/floor/wood,
/area/ruin/space/has_grav/powered)
"T" = (
/obj/item/shovel/spade,
/turf/open/floor/plating/asteroid/airless,
/area/ruin/space)
"W" = (
/obj/item/cultivator,
/turf/open/floor/plating/asteroid/airless,
/area/ruin/space)
"Y" = (
/obj/structure/table/wood,
/obj/item/phone,
/turf/open/floor/wood,
/area/ruin/space/has_grav/powered)
"Z" = (
/obj/item/seeds/tower,
/turf/open/floor/plating/asteroid/airless,
/area/ruin/space)

(1,1,1) = {"
q
q
q
d
d
d
d
q
q
q
q
d
d
d
q
q
q
"}
(2,1,1) = {"
q
q
d
p
p
p
p
d
d
d
d
p
p
p
d
q
q
"}
(3,1,1) = {"
q
d
p
p
p
p
p
p
p
p
p
p
p
p
p
d
q
"}
(4,1,1) = {"
d
p
p
p
p
p
p
p
p
p
t
t
t
t
p
p
d
"}
(5,1,1) = {"
d
p
p
d
d
d
e
j
p
p
t
M
J
t
p
p
d
"}
(6,1,1) = {"
d
p
p
d
d
d
F
o
p
p
t
E
L
t
p
p
d
"}
(7,1,1) = {"
q
d
d
s
s
s
s
d
t
t
t
c
t
t
t
p
d
"}
(8,1,1) = {"
q
d
d
d
A
g
W
d
t
Y
C
v
n
y
t
p
d
"}
(9,1,1) = {"
q
d
d
s
s
s
s
d
t
P
C
v
v
v
t
p
d
"}
(10,1,1) = {"
q
d
d
d
T
Z
d
d
m
v
v
v
v
v
t
p
d
"}
(11,1,1) = {"
q
d
d
s
s
s
s
d
t
v
v
v
v
v
t
p
d
"}
(12,1,1) = {"
q
d
d
d
w
A
d
d
t
t
i
N
K
a
t
p
d
"}
(13,1,1) = {"
q
d
p
s
s
s
s
d
p
t
t
t
t
t
t
p
q
"}
(14,1,1) = {"
d
p
p
p
d
d
d
p
p
p
p
p
p
p
p
d
q
"}
(15,1,1) = {"
d
p
p
p
p
p
p
p
p
p
p
p
p
d
d
q
q
"}
(16,1,1) = {"
d
p
p
p
p
p
p
p
p
p
p
p
p
d
q
q
q
"}
(17,1,1) = {"
q
d
p
p
p
p
d
d
d
d
d
d
d
q
q
q
q
"}
(18,1,1) = {"
q
q
d
d
d
d
q
q
q
q
q
q
q
q
q
q
q
"}
