//MAP CONVERTED BY dmm2tgm.py THIS HEADER COMMENT PREVENTS RECONVERSION, DO NOT REMOVE
"m" = (
/turf/open/floor/plating/asteroid/airless,
/area/ruin/space)
"n" = (
/turf/closed/mineral/random,
/area/ruin/space)
"B" = (
/obj/item/toy/plush/borgplushie,
/turf/open/floor/plating/asteroid/airless,
/area/ruin/space)
"J" = (
/turf/template_noop,
/area/template_noop)
"Y" = (
/obj/item/pickaxe/drill,
/turf/open/floor/plating/asteroid/airless,
/area/ruin/space)

(1,1,1) = {"
J
J
m
m
m
m
m
J
J
J
J
J
m
m
J
J
J
"}
(2,1,1) = {"
J
m
n
n
n
n
n
m
J
J
m
m
n
n
m
J
J
"}
(3,1,1) = {"
m
n
n
n
m
B
n
m
J
m
n
n
n
n
m
J
J
"}
(4,1,1) = {"
m
n
n
m
m
n
n
n
m
n
n
n
n
n
n
m
J
"}
(5,1,1) = {"
m
n
n
m
n
n
n
n
m
m
n
n
n
n
n
m
J
"}
(6,1,1) = {"
m
n
n
m
m
m
m
n
n
m
m
m
n
n
n
m
J
"}
(7,1,1) = {"
m
n
n
n
m
n
m
n
n
n
n
m
n
n
n
n
m
"}
(8,1,1) = {"
m
n
n
n
m
n
m
n
n
n
n
m
n
n
n
n
m
"}
(9,1,1) = {"
m
n
n
n
m
n
m
m
m
n
n
m
n
n
n
n
m
"}
(10,1,1) = {"
m
n
n
n
m
n
n
n
m
n
n
m
n
n
n
n
m
"}
(11,1,1) = {"
m
n
n
n
m
Y
n
n
m
n
n
m
m
n
n
n
m
"}
(12,1,1) = {"
m
n
n
n
n
n
n
m
m
m
m
m
n
n
n
m
J
"}
(13,1,1) = {"
J
m
n
n
n
m
n
m
n
n
n
n
n
n
m
J
J
"}
(14,1,1) = {"
J
m
n
n
n
m
m
m
n
n
n
n
n
n
m
J
J
"}
(15,1,1) = {"
J
J
m
m
n
n
n
n
n
n
n
n
n
n
m
J
J
"}
(16,1,1) = {"
J
J
J
J
m
m
n
n
n
n
n
n
m
m
J
J
J
"}
(17,1,1) = {"
J
J
J
J
J
J
m
m
m
m
m
m
J
J
J
J
J
"}
