//MAP CONVERTED BY dmm2tgm.py THIS HEADER COMMENT PREVENTS RECONVERSION, DO NOT REMOVE
"a" = (
/turf/open/floor/plating/asteroid/basalt/lava_land_surface,
/area/lavaland/surface/outdoors)
"b" = (
/obj/structure/sign/poster/contraband/lusty_xenomorph,
/turf/closed/wall/mineral/abductor,
/area/lavaland/surface)
"c" = (
/turf/open/floor/mineral/diamond,
/area/lavaland/surface)
"d" = (
/obj/item/reagent_containers/food/drinks/trophy/gold_cup,
/turf/open/floor/mineral/diamond,
/area/lavaland/surface)
"e" = (
/obj/item/greentext{
	light_color = "#64C864";
	light_range = 1
	},
/turf/open/floor/mineral/diamond,
/area/lavaland/surface)
"f" = (
/obj/item/tcg_card/special/xenomaid,
/turf/open/floor/mineral/diamond,
/area/lavaland/surface)

(1,1,1) = {"
a
a
a
a
a
a
a
a
a
a
a
"}
(2,1,1) = {"
a
a
a
a
a
a
a
a
a
a
a
"}
(3,1,1) = {"
a
a
a
a
b
b
b
a
a
a
a
"}
(4,1,1) = {"
a
a
a
b
f
c
c
b
a
a
a
"}
(5,1,1) = {"
a
a
b
c
c
d
c
c
b
a
a
"}
(6,1,1) = {"
a
a
b
c
d
e
d
c
b
a
a
"}
(7,1,1) = {"
a
a
b
c
c
d
c
c
b
a
a
"}
(8,1,1) = {"
a
a
a
b
c
c
c
b
a
a
a
"}
(9,1,1) = {"
a
a
a
a
b
b
b
a
a
a
a
"}
(10,1,1) = {"
a
a
a
a
a
a
a
a
a
a
a
"}
(11,1,1) = {"
a
a
a
a
a
a
a
a
a
a
a
"}
