//MAP CONVERTED BY dmm2tgm.py THIS HEADER COMMENT PREVENTS RECONVERSION, DO NOT REMOVE
"a" = (
/turf/closed/mineral/volcanic/lava_land_surface,
/area/lavaland/surface/outdoors)
"b" = (
/turf/closed/mineral/volcanic/lava_land_surface,
/area/ruin/lavaland/powered)
"c" = (
/turf/closed/wall/mineral/iron,
/area/ruin/lavaland/powered)
"d" = (
/obj/item/clothing/head/helmet/space/orange,
/obj/item/clothing/mask/breath,
/turf/open/floor/plating/asteroid/basalt,
/area/ruin/lavaland/powered)
"e" = (
/obj/item/clothing/suit/space/orange,
/turf/open/floor/plating/asteroid/basalt,
/area/ruin/lavaland/powered)
"f" = (
/turf/open/floor/plating/asteroid/basalt,
/area/ruin/lavaland/powered)
"g" = (
/turf/open/floor/plating/asteroid{
	name = "dirt"
	},
/area/ruin/lavaland/powered)
"h" = (
/obj/item/shovel,
/turf/open/floor/plating/asteroid{
	name = "dirt"
	},
/area/ruin/lavaland/powered)
"i" = (
/obj/item/reagent_containers/glass/bucket,
/turf/open/floor/plating/asteroid{
	name = "dirt"
	},
/area/ruin/lavaland/powered)
"j" = (
/obj/structure/sink/puddle,
/turf/open/floor/plating/asteroid{
	name = "dirt"
	},
/area/ruin/lavaland/powered)
"k" = (
/obj/structure/glowshroom/single,
/turf/open/floor/plating/asteroid{
	name = "dirt"
	},
/area/ruin/lavaland/powered)
"l" = (
/obj/item/storage/toolbox/emergency,
/turf/open/floor/plating/asteroid{
	name = "dirt"
	},
/area/ruin/lavaland/powered)
"m" = (
/obj/structure/rack,
/obj/item/seeds/reishi,
/obj/item/seeds/plump,
/obj/item/seeds/plump,
/obj/item/reagent_containers/food/snacks/grown/mushroom/glowshroom,
/turf/open/floor/plating/asteroid/basalt,
/area/ruin/lavaland/powered)
"n" = (
/obj/machinery/hydroponics/soil,
/turf/open/floor/plating,
/area/ruin/lavaland/powered)
"o" = (
/turf/open/floor/plating,
/area/ruin/lavaland/powered)
"p" = (
/obj/structure/rack,
/obj/item/storage/bag/plants/portaseeder,
/obj/item/storage/bag/ore,
/obj/item/storage/firstaid/regular,
/turf/open/floor/plating/asteroid/basalt,
/area/ruin/lavaland/powered)
"q" = (
/obj/structure/glowshroom/single,
/turf/open/floor/plating,
/area/ruin/lavaland/powered)
"r" = (
/obj/structure/rack,
/obj/item/pickaxe/emergency,
/obj/item/tank/internals/oxygen,
/turf/open/floor/plating/asteroid/basalt,
/area/ruin/lavaland/powered)
"s" = (
/turf/open/floor/plating/asteroid/basalt/lava_land_surface,
/area/lavaland/surface/outdoors)
"t" = (
/turf/closed/wall/mineral/titanium/survival/pod,
/area/ruin/lavaland/powered)
"u" = (
/obj/structure/bed/pod,
/obj/item/bedsheet/black,
/turf/open/floor/plating,
/area/ruin/lavaland/powered)
"v" = (
/obj/structure/fans,
/turf/open/floor/pod/dark,
/area/ruin/lavaland/powered)
"w" = (
/obj/machinery/smartfridge/survival_pod,
/turf/open/floor/pod/dark,
/area/ruin/lavaland/powered)
"x" = (
/obj/effect/mob_spawn/human/hermit,
/turf/open/floor/pod/dark,
/area/ruin/lavaland/powered)
"y" = (
/turf/open/floor/pod/dark,
/area/ruin/lavaland/powered)
"z" = (
/obj/machinery/light/small{
	dir = 4
	},
/obj/structure/tubes,
/turf/open/floor/plating,
/area/ruin/lavaland/powered)
"A" = (
/obj/structure/table,
/obj/item/kitchen/knife/combat/survival,
/turf/open/floor/plating,
/area/ruin/lavaland/powered)
"B" = (
/obj/structure/table/survival_pod,
/turf/open/floor/pod/dark,
/area/ruin/lavaland/powered)
"C" = (
/obj/structure/tubes,
/obj/item/crowbar,
/obj/effect/decal/cleanable/blood/drip,
/turf/open/floor/pod/dark,
/area/ruin/lavaland/powered)
"D" = (
/obj/effect/decal/cleanable/blood/footprints{
	dir = 1;
	icon_state = "blood1"
	},
/obj/machinery/door/airlock/survival_pod/glass,
/obj/structure/fans/tiny,
/turf/open/floor/pod/dark,
/area/ruin/lavaland/powered)
"E" = (
/obj/structure/shuttle/engine/propulsion/burst{
	dir = 8
	},
/turf/closed/wall/mineral/titanium/interior,
/area/ruin/lavaland/powered)
"F" = (
/turf/closed/wall/mineral/titanium,
/area/ruin/lavaland/powered)
"G" = (
/turf/closed/wall/mineral/titanium/interior,
/area/ruin/lavaland/powered)
"H" = (
/obj/machinery/door/airlock/titanium{
	name = "Escape Pod Airlock"
	},
/turf/open/floor/mineral/titanium/blue,
/area/ruin/lavaland/powered)
"I" = (
/obj/structure/chair{
	dir = 4
	},
/turf/open/floor/mineral/titanium/blue,
/area/ruin/lavaland/powered)
"J" = (
/obj/effect/spawner/structure/window/shuttle,
/turf/open/floor/plating{
	initial_gas_mix = "o2=14;n2=23;TEMP=300"
	},
/area/ruin/lavaland/powered)

(1,1,1) = {"
a
a
a
a
a
a
a
a
s
s
s
s
s
s
s
s
"}
(2,1,1) = {"
a
a
a
a
a
a
a
a
a
a
s
s
s
s
s
s
"}
(3,1,1) = {"
a
a
a
a
a
a
a
a
a
a
s
s
s
s
s
s
"}
(4,1,1) = {"
a
a
a
a
a
a
a
a
a
a
a
s
s
s
s
s
"}
(5,1,1) = {"
a
a
a
a
a
b
c
b
t
t
t
t
t
s
s
s
"}
(6,1,1) = {"
a
a
a
a
b
b
n
n
t
v
x
B
t
s
s
s
"}
(7,1,1) = {"
a
a
a
b
b
m
o
o
t
w
y
y
D
s
s
s
"}
(8,1,1) = {"
a
b
b
b
c
f
o
q
o
o
z
C
t
s
s
s
"}
(9,1,1) = {"
b
b
f
i
g
f
f
o
o
o
t
t
t
s
s
s
"}
(10,1,1) = {"
b
d
g
j
g
g
f
f
u
o
A
b
a
s
s
s
"}
(11,1,1) = {"
c
e
h
g
l
c
p
r
c
c
c
b
a
a
s
s
"}
(12,1,1) = {"
b
b
f
k
f
b
b
b
b
a
a
a
a
E
H
E
"}
(13,1,1) = {"
a
b
b
b
b
b
a
a
a
a
a
a
a
F
I
F
"}
(14,1,1) = {"
a
a
a
a
a
a
a
a
a
a
a
a
a
F
I
F
"}
(15,1,1) = {"
a
a
a
a
a
a
a
a
a
a
a
a
a
G
J
G
"}
(16,1,1) = {"
a
a
a
a
a
a
a
a
a
a
a
a
a
a
a
a
"}
