//MAP CONVERTED BY dmm2tgm.py THIS HEADER COMMENT PREVENTS RECONVERSION, DO NOT REMOVE
"aa" = (
/turf/template_noop,
/area/template_noop)
"ab" = (
/turf/open/lava/smooth/lava_land_surface,
/area/lavaland/surface/outdoors)
"ac" = (
/obj/structure/alien/resin/wall,
/obj/structure/alien/weeds,
/turf/open/floor/plating/asteroid/basalt/lava_land_surface,
/area/ruin/lavaland/unpowered/xenonest)
"ad" = (
/obj/structure/alien/weeds,
/obj/effect/decal/cleanable/blood/gibs,
/turf/open/floor/plating/asteroid/basalt/lava_land_surface,
/area/ruin/lavaland/unpowered/xenonest)
"ae" = (
/obj/structure/alien/weeds,
/mob/living/simple_animal/hostile/alien/maid,
/turf/open/floor/plating/asteroid/basalt/lava_land_surface,
/area/ruin/lavaland/unpowered/xenonest)
"af" = (
/obj/structure/alien/weeds,
/obj/structure/alien/egg/burst,
/turf/open/floor/plating/asteroid/basalt/lava_land_surface,
/area/ruin/lavaland/unpowered/xenonest)
"ag" = (
/obj/structure/alien/weeds,
/turf/open/floor/plating/asteroid/basalt/lava_land_surface,
/area/ruin/lavaland/unpowered/xenonest)
"ah" = (
/obj/structure/bed/nest,
/obj/structure/alien/weeds,
/turf/open/floor/plating/asteroid/basalt/lava_land_surface,
/area/ruin/lavaland/unpowered/xenonest)
"aj" = (
/obj/structure/alien/weeds,
/obj/structure/bed/nest,
/obj/item/clothing/mask/facehugger/impregnated,
/obj/item/storage/backpack/clown,
/obj/item/bikehorn,
/turf/open/floor/plating/asteroid/basalt/lava_land_surface,
/area/ruin/lavaland/unpowered/xenonest)
"ak" = (
/obj/structure/alien/resin/membrane,
/obj/structure/alien/weeds,
/turf/open/floor/plating/asteroid/basalt/lava_land_surface,
/area/ruin/lavaland/unpowered/xenonest)
"al" = (
/obj/structure/alien/weeds,
/mob/living/simple_animal/hostile/alien/drone,
/turf/open/floor/plating/asteroid/basalt/lava_land_surface,
/area/ruin/lavaland/unpowered/xenonest)
"am" = (
/obj/structure/alien/weeds,
/obj/structure/bed/nest,
/turf/open/floor/plating/asteroid/basalt/lava_land_surface,
/area/ruin/lavaland/unpowered/xenonest)
"an" = (
/turf/closed/mineral/volcanic/lava_land_surface,
/area/lavaland/surface/outdoors)
"ao" = (
/obj/structure/alien/weeds/node,
/obj/effect/decal/cleanable/blood,
/turf/open/floor/plating/asteroid/basalt/lava_land_surface,
/area/ruin/lavaland/unpowered/xenonest)
"ap" = (
/obj/structure/bed/nest,
/obj/structure/alien/weeds,
/obj/item/clothing/mask/facehugger/impregnated,
/obj/item/clothing/glasses/night,
/obj/item/clothing/gloves/tackler/combat/insulated,
/obj/effect/decal/cleanable/blood/old,
/obj/item/clothing/under/syndicate/tacticool,
/turf/open/floor/plating/asteroid/basalt/lava_land_surface,
/area/ruin/lavaland/unpowered/xenonest)
"aq" = (
/obj/structure/alien/weeds,
/obj/structure/alien/egg/burst,
/obj/effect/decal/cleanable/blood,
/turf/open/floor/plating/asteroid/basalt/lava_land_surface,
/area/ruin/lavaland/unpowered/xenonest)
"ar" = (
/obj/structure/alien/weeds/node,
/turf/open/floor/plating/asteroid/basalt/lava_land_surface,
/area/ruin/lavaland/unpowered/xenonest)
"as" = (
/obj/structure/alien/resin/wall,
/obj/structure/alien/weeds,
/obj/structure/alien/weeds,
/turf/open/floor/plating/asteroid/basalt/lava_land_surface,
/area/ruin/lavaland/unpowered/xenonest)
"at" = (
/obj/structure/alien/weeds,
/obj/structure/alien/resin/wall,
/turf/open/floor/plating/asteroid/basalt/lava_land_surface,
/area/ruin/lavaland/unpowered/xenonest)
"au" = (
/obj/structure/alien/weeds,
/obj/item/grown/bananapeel,
/turf/open/floor/plating/asteroid/basalt/lava_land_surface,
/area/ruin/lavaland/unpowered/xenonest)
"av" = (
/obj/structure/alien/weeds,
/mob/living/simple_animal/hostile/alien/sentinel,
/turf/open/floor/plating/asteroid/basalt/lava_land_surface,
/area/ruin/lavaland/unpowered/xenonest)
"aw" = (
/obj/structure/alien/weeds,
/obj/structure/alien/resin/membrane,
/turf/open/floor/plating/asteroid/basalt/lava_land_surface,
/area/ruin/lavaland/unpowered/xenonest)
"ax" = (
/obj/structure/alien/weeds,
/obj/effect/decal/cleanable/blood/gibs,
/obj/structure/alien/weeds/node,
/mob/living/simple_animal/hostile/alien/drone,
/turf/open/floor/plating/asteroid/basalt/lava_land_surface,
/area/ruin/lavaland/unpowered/xenonest)
"ay" = (
/obj/structure/stone_tile/slab/cracked,
/turf/open/indestructible/boss,
/area/ruin/lavaland/unpowered/xenonest)
"aA" = (
/obj/structure/alien/weeds,
/obj/item/flamethrower,
/turf/open/floor/plating/asteroid/basalt/lava_land_surface,
/area/ruin/lavaland/unpowered/xenonest)
"aB" = (
/obj/structure/alien/weeds,
/obj/item/ammo_casing/c45,
/obj/effect/decal/cleanable/blood/gibs,
/mob/living/simple_animal/hostile/alien/sentinel,
/turf/open/floor/plating/asteroid/basalt/lava_land_surface,
/area/ruin/lavaland/unpowered/xenonest)
"aC" = (
/obj/structure/alien/weeds,
/obj/item/ammo_casing/c45{
	pixel_x = -6
	},
/turf/open/floor/plating/asteroid/basalt/lava_land_surface,
/area/ruin/lavaland/unpowered/xenonest)
"aD" = (
/obj/structure/stone_tile/surrounding_tile{
	dir = 1
	},
/obj/structure/stone_tile/surrounding_tile,
/obj/structure/stone_tile/surrounding_tile/cracked{
	dir = 4
	},
/obj/structure/stone_tile/center,
/turf/open/chasm/lavaland,
/area/ruin/lavaland/unpowered/xenonest)
"aE" = (
/obj/structure/alien/weeds,
/obj/effect/decal/cleanable/ash,
/turf/open/floor/plating/asteroid/basalt/lava_land_surface,
/area/ruin/lavaland/unpowered/xenonest)
"aF" = (
/obj/structure/alien/weeds,
/mob/living/simple_animal/hostile/alien,
/turf/open/floor/plating/asteroid/basalt/lava_land_surface,
/area/ruin/lavaland/unpowered/xenonest)
"aG" = (
/obj/structure/alien/weeds,
/obj/structure/mecha_wreckage/ripley,
/turf/open/floor/plating/asteroid/basalt/lava_land_surface,
/area/ruin/lavaland/unpowered/xenonest)
"aH" = (
/obj/structure/alien/weeds,
/obj/effect/decal/cleanable/blood/tracks,
/turf/open/floor/plating/asteroid/basalt/lava_land_surface,
/area/ruin/lavaland/unpowered/xenonest)
"aI" = (
/obj/structure/alien/weeds,
/obj/effect/decal/cleanable/vomit/old,
/turf/open/floor/plating/asteroid/basalt/lava_land_surface,
/area/ruin/lavaland/unpowered/xenonest)
"aJ" = (
/obj/structure/alien/weeds,
/obj/effect/decal/cleanable/blood,
/turf/open/floor/plating/asteroid/basalt/lava_land_surface,
/area/ruin/lavaland/unpowered/xenonest)
"aK" = (
/obj/structure/stone_tile/surrounding_tile/cracked{
	dir = 4
	},
/obj/structure/stone_tile/surrounding_tile/cracked{
	dir = 8
	},
/obj/structure/stone_tile/surrounding_tile/cracked{
	dir = 1
	},
/obj/structure/stone_tile/center/cracked,
/turf/open/chasm/lavaland,
/area/ruin/lavaland/unpowered/xenonest)
"aL" = (
/obj/structure/alien/weeds,
/obj/item/tank/internals/plasma,
/turf/open/floor/plating/asteroid/basalt/lava_land_surface,
/area/ruin/lavaland/unpowered/xenonest)
"aM" = (
/obj/structure/alien/weeds,
/obj/effect/decal/cleanable/blood/xeno,
/turf/open/floor/plating/asteroid/basalt/lava_land_surface,
/area/ruin/lavaland/unpowered/xenonest)
"aN" = (
/obj/structure/stone_tile/block{
	dir = 8
	},
/obj/structure/stone_tile{
	dir = 1
	},
/obj/structure/stone_tile/cracked,
/turf/open/indestructible/boss,
/area/ruin/lavaland/unpowered/xenonest)
"aO" = (
/obj/structure/alien/weeds,
/obj/effect/mob_spawn/alien/corpse/humanoid/sentinel,
/turf/open/floor/plating/asteroid/basalt/lava_land_surface,
/area/ruin/lavaland/unpowered/xenonest)
"aP" = (
/obj/structure/alien/weeds,
/obj/effect/mob_spawn/alien/corpse/humanoid/hunter,
/turf/open/floor/plating/asteroid/basalt/lava_land_surface,
/area/ruin/lavaland/unpowered/xenonest)
"aQ" = (
/obj/structure/alien/weeds,
/obj/structure/bed/nest,
/obj/item/clothing/mask/facehugger/impregnated,
/obj/item/clothing/suit/bio_suit/security,
/obj/item/clothing/head/bio_hood/security,
/obj/item/clothing/mask/breath,
/obj/item/flashlight/seclite,
/turf/open/floor/plating/asteroid/basalt/lava_land_surface,
/area/ruin/lavaland/unpowered/xenonest)
"aS" = (
/obj/structure/alien/weeds,
/obj/structure/bed/nest,
/obj/item/clothing/mask/facehugger/impregnated,
/turf/open/floor/plating/asteroid/basalt/lava_land_surface,
/area/ruin/lavaland/unpowered/xenonest)
"aT" = (
/obj/structure/alien/weeds,
/obj/item/chainsaw,
/turf/open/floor/plating/asteroid/basalt/lava_land_surface,
/area/ruin/lavaland/unpowered/xenonest)
"aU" = (
/obj/structure/alien/weeds,
/obj/structure/bed/nest,
/obj/item/fireaxe/boneaxe,
/obj/item/clothing/head/helmet/gladiator,
/obj/item/clothing/mask/facehugger/impregnated,
/turf/open/floor/plating/asteroid/basalt/lava_land_surface,
/area/ruin/lavaland/unpowered/xenonest)
"aV" = (
/obj/structure/alien/weeds,
/obj/structure/bed/nest,
/obj/item/clothing/mask/facehugger/impregnated,
/obj/effect/decal/cleanable/blood,
/turf/open/floor/plating/asteroid/basalt/lava_land_surface,
/area/ruin/lavaland/unpowered/xenonest)
"aW" = (
/obj/structure/alien/resin/wall,
/turf/open/floor/plating/asteroid/basalt/lava_land_surface,
/area/ruin/lavaland/unpowered/xenonest)
"aX" = (
/obj/structure/alien/weeds,
/obj/effect/gibspawner/xeno,
/turf/open/floor/plating/asteroid/basalt/lava_land_surface,
/area/ruin/lavaland/unpowered/xenonest)
"aZ" = (
/turf/closed/indestructible/riveted/boss,
/area/ruin/lavaland/unpowered/xenonest)
"ba" = (
/obj/structure/stone_tile/slab,
/turf/open/indestructible/boss,
/area/ruin/lavaland/unpowered/xenonest)
"bb" = (
/obj/structure/stone_tile/cracked{
	dir = 4
	},
/obj/structure/stone_tile,
/obj/structure/stone_tile{
	dir = 1
	},
/obj/structure/stone_tile{
	dir = 8
	},
/obj/item/flashlight/lantern,
/turf/open/indestructible/boss,
/area/ruin/lavaland/unpowered/xenonest)
"bc" = (
/obj/structure/stone_tile/block,
/obj/structure/stone_tile{
	dir = 1
	},
/obj/structure/stone_tile{
	dir = 4
	},
/turf/open/indestructible/boss,
/area/ruin/lavaland/unpowered/xenonest)
"bd" = (
/obj/structure/stone_tile/block,
/obj/structure/stone_tile{
	dir = 4
	},
/obj/structure/stone_tile/cracked{
	dir = 1
	},
/obj/effect/decal/cleanable/blood/xeno,
/turf/open/indestructible/boss,
/area/ruin/lavaland/unpowered/xenonest)
"be" = (
/obj/structure/stone_tile/block,
/obj/structure/stone_tile{
	dir = 4
	},
/obj/structure/stone_tile{
	dir = 1
	},
/turf/open/indestructible/boss,
/area/ruin/lavaland/unpowered/xenonest)
"bf" = (
/obj/structure/stone_tile,
/obj/structure/stone_tile{
	dir = 1
	},
/obj/structure/stone_tile{
	dir = 8
	},
/obj/structure/stone_tile{
	dir = 4
	},
/obj/item/flashlight/lantern,
/turf/open/indestructible/boss,
/area/ruin/lavaland/unpowered/xenonest)
"bg" = (
/obj/structure/alien/weeds,
/obj/item/clothing/mask/facehugger/dead,
/turf/open/floor/plating/asteroid/basalt/lava_land_surface,
/area/ruin/lavaland/unpowered/xenonest)
"bh" = (
/obj/structure/stone_tile/block/cracked{
	dir = 4
	},
/obj/structure/stone_tile/cracked{
	dir = 4
	},
/obj/structure/stone_tile{
	dir = 8
	},
/turf/open/indestructible/boss,
/area/ruin/lavaland/unpowered/xenonest)
"bi" = (
/obj/structure/alien/weeds,
/obj/structure/bed/nest,
/obj/item/clothing/mask/facehugger/impregnated,
/obj/item/book_of_babel,
/obj/item/clothing/head/wizard/black,
/turf/open/floor/plating/asteroid/basalt/lava_land_surface,
/area/ruin/lavaland/unpowered/xenonest)
"bj" = (
/obj/structure/stone_tile/surrounding_tile/cracked,
/obj/structure/stone_tile/surrounding_tile{
	dir = 8
	},
/obj/structure/stone_tile/surrounding_tile/cracked{
	dir = 1
	},
/obj/structure/stone_tile/center/cracked,
/turf/open/chasm/lavaland,
/area/ruin/lavaland/unpowered/xenonest)
"bk" = (
/obj/structure/stone_tile/block,
/turf/open/chasm/lavaland,
/area/ruin/lavaland/unpowered/xenonest)
"bl" = (
/obj/structure/stone_tile/block{
	dir = 8
	},
/obj/structure/stone_tile{
	dir = 1
	},
/obj/structure/stone_tile,
/turf/open/indestructible/boss,
/area/ruin/lavaland/unpowered/xenonest)
"bn" = (
/obj/structure/stone_tile/block{
	dir = 4
	},
/obj/structure/stone_tile{
	dir = 8
	},
/obj/structure/stone_tile{
	dir = 4
	},
/turf/open/indestructible/boss,
/area/ruin/lavaland/unpowered/xenonest)
"bo" = (
/obj/structure/stone_tile/surrounding_tile{
	dir = 8
	},
/obj/structure/stone_tile/surrounding_tile{
	dir = 4
	},
/obj/structure/stone_tile/surrounding_tile,
/obj/structure/stone_tile/center,
/turf/open/chasm/lavaland,
/area/ruin/lavaland/unpowered/xenonest)
"bq" = (
/turf/open/chasm/lavaland,
/area/ruin/lavaland/unpowered/xenonest)
"br" = (
/obj/structure/stone_tile/block/cracked{
	dir = 8
	},
/obj/structure/stone_tile,
/obj/structure/stone_tile{
	dir = 1
	},
/obj/effect/decal/cleanable/blood/xeno,
/turf/open/indestructible/boss,
/area/ruin/lavaland/unpowered/xenonest)
"bs" = (
/obj/structure/stone_tile/block{
	dir = 8
	},
/turf/open/chasm/lavaland,
/area/ruin/lavaland/unpowered/xenonest)
"bw" = (
/obj/structure/stone_tile/cracked{
	dir = 4
	},
/obj/structure/stone_tile/cracked,
/obj/structure/stone_tile{
	dir = 1
	},
/obj/structure/stone_tile{
	dir = 8
	},
/obj/item/flashlight/lantern,
/turf/open/indestructible/boss,
/area/ruin/lavaland/unpowered/xenonest)
"bx" = (
/obj/structure/stone_tile/block{
	dir = 1
	},
/obj/structure/stone_tile,
/obj/structure/stone_tile{
	dir = 8
	},
/obj/effect/decal/cleanable/blood/xeno,
/turf/open/indestructible/boss,
/area/ruin/lavaland/unpowered/xenonest)
"by" = (
/obj/structure/stone_tile/block{
	dir = 1
	},
/obj/structure/stone_tile,
/obj/structure/stone_tile/cracked{
	dir = 8
	},
/turf/open/indestructible/boss,
/area/ruin/lavaland/unpowered/xenonest)
"bz" = (
/obj/structure/stone_tile/block/cracked{
	dir = 1
	},
/obj/structure/stone_tile/cracked,
/obj/structure/stone_tile{
	dir = 8
	},
/turf/open/indestructible/boss,
/area/ruin/lavaland/unpowered/xenonest)
"bA" = (
/obj/structure/stone_tile/cracked{
	dir = 1
	},
/obj/structure/stone_tile{
	dir = 4
	},
/obj/structure/stone_tile{
	dir = 8
	},
/obj/structure/stone_tile,
/obj/item/flashlight/lantern,
/turf/open/indestructible/boss,
/area/ruin/lavaland/unpowered/xenonest)
"bB" = (
/obj/structure/alien/weeds,
/obj/effect/decal/cleanable/blood/old,
/turf/open/floor/plating/asteroid/basalt/lava_land_surface,
/area/ruin/lavaland/unpowered/xenonest)
"bC" = (
/obj/structure/alien/weeds,
/obj/structure/bed/nest,
/mob/living/simple_animal/hostile/alien,
/turf/open/floor/plating/asteroid/basalt/lava_land_surface,
/area/ruin/lavaland/unpowered/xenonest)
"dE" = (
/obj/structure/alien/weeds,
/obj/structure/bed/nest,
/obj/item/healthanalyzer,
/obj/item/clothing/suit/bio_suit/scientist,
/obj/item/reagent_containers/hypospray/medipen,
/obj/item/clothing/mask/facehugger/impregnated,
/turf/open/floor/plating/asteroid/basalt/lava_land_surface,
/area/ruin/lavaland/unpowered/xenonest)
"gA" = (
/obj/structure/alien/weeds,
/obj/structure/bed/nest,
/obj/effect/mob_spawn/alien/corpse/humanoid/sentinel,
/turf/open/floor/plating/asteroid/basalt/lava_land_surface,
/area/ruin/lavaland/unpowered/xenonest)
"iA" = (
/obj/structure/alien/weeds,
/obj/structure/bed/nest,
/obj/item/clothing/head/welding,
/obj/item/weldingtool/largetank,
/obj/item/clothing/mask/facehugger/impregnated,
/turf/open/floor/plating/asteroid/basalt/lava_land_surface,
/area/ruin/lavaland/unpowered/xenonest)
"lG" = (
/obj/structure/alien/weeds,
/obj/effect/mob_spawn/alien/corpse/humanoid/drone,
/turf/open/floor/plating/asteroid/basalt/lava_land_surface,
/area/ruin/lavaland/unpowered/xenonest)
"lM" = (
/obj/structure/stone_tile/block{
	dir = 4
	},
/turf/open/chasm/lavaland,
/area/ruin/lavaland/unpowered/xenonest)
"nj" = (
/obj/effect/mob_spawn/alien/corpse/humanoid/praetorian,
/turf/open/floor/plating/asteroid/basalt/lava_land_surface,
/area/ruin/lavaland/unpowered/xenonest)
"tY" = (
/obj/structure/alien/weeds/node,
/obj/effect/mob_spawn/alien/corpse/humanoid/hunter,
/turf/open/floor/plating/asteroid/basalt/lava_land_surface,
/area/ruin/lavaland/unpowered/xenonest)
"wA" = (
/obj/structure/alien/weeds,
/obj/structure/alien/weeds/node,
/turf/open/floor/plating/asteroid/basalt/lava_land_surface,
/area/ruin/lavaland/unpowered/xenonest)
"yf" = (
/obj/structure/alien/weeds/node,
/mob/living/simple_animal/hostile/alien/sentinel,
/turf/open/floor/plating/asteroid/basalt/lava_land_surface,
/area/ruin/lavaland/unpowered/xenonest)
"zj" = (
/obj/structure/stone_tile/block/cracked{
	dir = 1
	},
/turf/open/chasm/lavaland,
/area/ruin/lavaland/unpowered/xenonest)
"Dd" = (
/obj/structure/alien/weeds,
/obj/effect/decal/cleanable/blood/gibs,
/obj/item/storage/backpack/duffelbag/sec/surgery,
/turf/open/floor/plating/asteroid/basalt/lava_land_surface,
/area/ruin/lavaland/unpowered/xenonest)
"Ha" = (
/obj/structure/alien/weeds,
/obj/item/reagent_containers/syringe/alien,
/turf/open/floor/plating/asteroid/basalt/lava_land_surface,
/area/ruin/lavaland/unpowered/xenonest)
"JM" = (
/obj/structure/alien/weeds/node,
/obj/effect/mob_spawn/alien/corpse/humanoid/drone,
/turf/open/floor/plating/asteroid/basalt/lava_land_surface,
/area/ruin/lavaland/unpowered/xenonest)
"QG" = (
/obj/structure/alien/weeds,
/obj/structure/bed/nest,
/obj/structure/alien/weeds/node,
/turf/open/floor/plating/asteroid/basalt/lava_land_surface,
/area/ruin/lavaland/unpowered/xenonest)
"Uh" = (
/obj/structure/alien/weeds,
/obj/item/xenos_claw,
/turf/open/floor/plating/asteroid/basalt/lava_land_surface,
/area/ruin/lavaland/unpowered/xenonest)
"Vi" = (
/obj/structure/bed/nest,
/obj/structure/alien/weeds,
/obj/item/clothing/suit/space/hardsuit/mining,
/obj/item/clothing/gloves/color/black,
/obj/item/radio/headset/headset_cargo/mining,
/obj/item/clothing/mask/facehugger/impregnated,
/turf/open/floor/plating/asteroid/basalt/lava_land_surface,
/area/ruin/lavaland/unpowered/xenonest)
"VZ" = (
/obj/structure/alien/weeds,
/obj/effect/gibspawner/human,
/turf/open/floor/plating/asteroid/basalt/lava_land_surface,
/area/ruin/lavaland/unpowered/xenonest)
"ZT" = (
/obj/effect/mob_spawn/human/corpse/syndicatesoldier,
/turf/open/floor/plating/asteroid/basalt/lava_land_surface,
/area/ruin/lavaland/unpowered/xenonest)

(1,1,1) = {"
aa
ab
ab
ab
ab
ab
ab
ab
aa
aa
aa
aa
aa
ab
ab
ab
ab
ab
ab
ab
ab
ab
ab
ab
ab
ab
ab
ab
ab
ab
ab
ab
aa
aa
aa
aa
aa
aa
aa
aa
aa
aa
aa
aa
aa
aa
aa
aa
aa
"}
(2,1,1) = {"
ab
ab
ac
ac
ac
ac
ac
ab
ab
ab
ab
ab
ab
ab
ac
ac
ac
ac
ac
ac
ac
ac
ab
ab
ac
ac
ac
ac
ac
ac
ac
ab
ab
ab
aa
aa
aa
aa
aa
aa
aa
aa
aa
aa
aa
aa
aa
aa
aa
"}
(3,1,1) = {"
ab
ac
ac
aj
ac
QG
ac
ac
ac
ac
ab
ab
ac
ac
ac
aU
ak
ag
ar
aH
aJ
ac
ac
ac
ac
aS
ak
am
ak
am
ac
ac
ac
ab
ab
ab
ab
aa
aa
aa
aa
aa
aa
aa
aa
aa
aa
aa
aa
"}
(4,1,1) = {"
ab
ac
ad
ad
af
ag
ak
ag
ag
ac
ac
ac
ac
ag
af
ag
aE
ag
aF
ac
ag
ag
aL
ag
ag
VZ
ag
ag
ag
ar
ag
af
ac
ac
ac
ac
ab
ab
aa
aa
aa
aa
aa
aa
aa
aa
aa
aa
aa
"}
(5,1,1) = {"
ab
ac
ae
ak
ar
ag
au
ag
ag
av
ac
ag
ag
ag
ar
ag
ac
ac
ac
ac
wA
ag
ag
ar
ag
af
ac
ac
ac
ag
ag
ag
ag
ag
ag
ac
ac
ab
ab
aa
aa
aa
aa
aa
aa
aa
aa
aa
aa
"}
(6,1,1) = {"
ab
ac
af
ak
ag
lG
ac
ac
ag
ar
ag
ag
aA
ag
ac
ac
ac
an
an
ac
ac
ac
aM
ag
ac
ac
ac
an
ac
al
ac
ag
ag
ao
ag
ag
ac
ac
ab
aa
aa
aa
aa
aa
aa
aa
aa
aa
aa
"}
(7,1,1) = {"
ab
ac
wA
ag
ag
ag
aF
ag
ag
ag
ac
ac
ag
ac
ac
ac
an
an
an
an
an
ac
ag
ac
ac
an
an
an
ac
ac
ac
ac
ac
ZT
ac
wA
ag
ac
ab
aa
aa
aa
aa
aa
aa
aa
aa
aa
aa
"}
(8,1,1) = {"
ab
ac
ac
am
ac
af
ar
ag
ac
ac
ac
am
aF
ag
ag
ac
ac
an
an
an
an
an
an
an
an
an
an
an
an
an
an
an
ac
ac
ac
ag
ag
ac
ab
aa
aa
aa
aa
aa
aa
aa
aa
aa
aa
"}
(9,1,1) = {"
ab
ab
ac
ac
ac
ac
am
ac
ac
an
ac
ac
ag
ar
ag
ag
ac
ac
ac
an
an
an
an
an
an
an
ac
ac
ac
ac
an
an
an
an
ac
ac
ar
ac
ab
ab
aa
aa
aa
aa
aa
aa
aa
aa
aa
"}
(10,1,1) = {"
aa
ab
ab
an
an
ac
ac
ac
an
an
an
ac
ac
ac
ag
ag
ag
ag
ac
an
an
an
an
an
ac
ac
ac
bi
ax
ac
ac
ac
an
an
ac
ag
ag
ac
ac
ab
aa
aa
aa
aa
aa
aa
aa
aa
aa
"}
(11,1,1) = {"
aa
ab
ab
ab
an
an
an
an
an
an
an
an
an
ac
ag
ac
ac
ar
ac
ac
an
an
an
ac
ac
gA
ac
ac
aJ
ak
af
ac
ac
an
ac
ag
ag
ag
ac
ab
ab
ab
aa
aa
aa
aa
aa
aa
aa
"}
(12,1,1) = {"
aa
ab
ab
ab
ab
ab
an
an
an
an
an
an
an
ac
ac
ac
aF
ag
ag
ac
ac
an
an
ac
am
ag
ar
ag
ag
ag
ag
aF
ac
an
ac
ac
ag
ag
ac
ac
ac
ab
aa
aa
aa
aa
aa
aa
aa
"}
(13,1,1) = {"
aa
ab
ab
ac
ac
ac
ac
ac
ac
ac
ac
an
an
an
an
ac
ac
aG
ag
iA
ac
an
an
ac
ac
aJ
af
ag
ac
ac
ar
ag
ac
an
an
ac
ag
ar
ag
ag
ac
ac
aa
aa
aa
aa
aa
aa
aa
"}
(14,1,1) = {"
ab
ab
ac
ac
af
ag
af
aw
aF
am
ac
an
an
an
an
an
ag
ag
ag
ak
ac
an
an
ac
Dd
ag
ak
aP
af
ac
ag
ac
ac
an
an
ac
ac
ag
ag
ag
dE
ac
aa
aa
aa
aa
aa
aa
aa
"}
(15,1,1) = {"
ab
ac
ac
ag
ag
at
ag
ac
ag
at
ac
ac
ac
ac
an
an
ac
ac
ar
af
ac
ac
an
ac
aV
ac
ac
ac
ac
av
ag
bg
ac
ac
an
an
ac
ac
ac
ag
ac
ac
aa
aa
aa
aa
aa
aa
aa
"}
(16,1,1) = {"
ab
ac
af
ag
tY
lG
ag
ag
wA
ad
ag
ag
ag
ac
ac
an
an
ac
ag
aI
am
ac
an
ac
ac
ac
an
an
ac
ac
af
ag
ag
ac
an
an
an
an
ac
ar
bC
ac
aa
aa
aa
aa
aa
aa
aa
"}
(17,1,1) = {"
ab
ac
af
ag
ag
ag
af
ac
ag
af
ao
aB
ag
ag
ac
an
an
ac
ag
ad
ac
ac
an
an
an
an
an
an
an
ac
ac
ac
ar
ac
an
an
an
ac
ac
ag
ak
ac
aa
aa
aa
aa
aa
aa
aa
"}
(18,1,1) = {"
ab
ac
ac
ag
ac
ak
ac
ac
ag
at
aQ
at
ag
aw
ac
ac
an
ac
ak
ag
ac
an
an
an
an
an
an
an
an
an
ac
ag
aX
ac
an
an
an
ac
ag
ag
am
ac
aa
aa
aa
aa
aa
aa
aa
"}
(19,1,1) = {"
ab
ac
ah
af
ah
ar
Vi
ak
ag
ag
at
ag
ag
ag
af
ac
ac
ac
yf
ag
ac
ac
an
an
an
an
an
an
an
ab
ab
ac
ag
ac
ab
ab
an
ac
ar
bB
ac
ac
aa
aa
aa
ac
ag
ag
aa
"}
(20,1,1) = {"
ab
ac
ac
ah
ac
ah
ag
ac
aF
ag
ar
ag
ag
ar
ag
ak
ar
ag
ag
ag
ag
ac
ac
ac
ac
ac
ac
an
ab
ab
ab
ac
ag
ac
ab
ab
ab
ac
ag
ag
ac
ac
aa
aa
aa
aa
ac
ag
aa
"}
(21,1,1) = {"
ab
ac
ah
ao
ah
ac
ag
wA
ag
ag
nj
ag
at
ag
aC
ak
ar
ag
ag
ag
ag
ag
ak
ag
ac
am
ac
an
ab
aZ
aZ
aZ
ay
aZ
aZ
aZ
ab
ac
ag
ag
ag
ac
ac
ac
aa
aa
ac
ag
ag
"}
(22,1,1) = {"
ab
ac
ac
ap
ac
ah
af
ac
at
ag
ag
ag
ag
ag
ag
ac
ac
ac
ac
ag
ag
ar
ag
ag
aT
af
ac
aW
ab
aZ
bb
bh
bn
bn
bw
aZ
ab
ac
ag
ag
ar
ag
af
ac
ac
ac
aW
ag
ag
"}
(23,1,1) = {"
ab
ac
ah
aq
ah
ar
ah
ak
Ha
at
ag
ag
aw
af
ac
ac
ab
ab
ac
ac
ac
ac
ag
ag
ag
ar
ag
ac
ac
aZ
bc
bj
lM
aD
bx
aZ
ab
ac
ac
ag
ag
ag
ag
ag
aw
ar
ag
ag
ag
"}
(24,1,1) = {"
ab
ac
ac
ag
ac
ak
ac
ac
at
ag
av
ag
ac
ac
ac
ab
ab
ab
ab
ab
ab
ac
ac
ac
aF
ag
aX
ag
ag
ba
bd
bk
bq
zj
by
aZ
ab
ab
ac
ac
ac
ac
wA
ag
aw
ar
ag
ag
ag
"}
(25,1,1) = {"
ab
ac
ag
ag
JM
ag
ag
ac
ag
ar
ag
aO
ac
ab
ab
ab
aa
aa
aa
aa
ab
ab
ab
ac
ac
ac
ag
Uh
wA
aZ
be
bo
bs
aK
bz
aZ
ab
ab
ab
aa
aa
ac
ac
ac
ac
ac
ac
ag
ag
"}
(26,1,1) = {"
ab
ac
ac
af
ag
af
ag
aF
ag
ag
aw
am
ac
ab
aa
aa
aa
aa
aa
aa
aa
aa
ab
ab
ab
ac
ac
ac
ac
aZ
bf
bl
br
aN
bA
aZ
ab
ab
ab
aa
aa
aa
aa
aa
aa
aa
ac
ac
ac
"}
(27,1,1) = {"
ab
ab
ac
ac
as
at
at
ac
ac
ac
ac
ac
ac
ab
aa
aa
aa
aa
aa
aa
aa
aa
aa
aa
ab
ab
ab
ab
ab
aZ
aZ
aZ
aZ
aZ
aZ
aZ
ab
ab
aa
aa
aa
aa
aa
aa
aa
aa
aa
aa
aa
"}
(28,1,1) = {"
aa
ab
ab
ab
ab
ab
ab
ab
ab
ab
ab
ab
ab
ab
aa
aa
aa
aa
aa
aa
aa
aa
aa
aa
aa
aa
aa
aa
ab
ab
ab
ab
ab
ab
ab
ab
ab
aa
aa
aa
aa
aa
aa
aa
aa
aa
aa
aa
aa
"}
