//MAP CONVERTED BY dmm2tgm.py THIS HEADER COMMENT PREVENTS RECONVERSION, DO NOT REMOVE
"av" = (
/obj/machinery/atmospherics/pipe/simple/scrubbers/hidden,
/obj/machinery/atmospherics/pipe/simple/supply/hidden{
	dir = 4
	},
/obj/effect/spawner/structure/window/plasma/reinforced,
/turf/open/floor/plating,
/area/engineering/main)
"aW" = (
/obj/structure/lattice,
/obj/structure/grille,
/turf/open/space/basic,
/area/space/nearstation)
"cP" = (
/obj/structure/table,
/obj/item/clothing/gloves/color/yellow,
/obj/item/storage/toolbox/electrical{
	pixel_y = 5
	},
/turf/open/floor/plasteel,
/area/engineering/main)
"cS" = (
/obj/machinery/atmospherics/pipe/simple/scrubbers/hidden{
	dir = 4
	},
/obj/structure/sign/poster/official/safety_eye_protection,
/turf/closed/wall/r_wall,
/area/engineering/main)
"dl" = (
/obj/structure/cable{
	icon_state = "1-4"
	},
/turf/open/floor/plasteel,
/area/engineering/main)
"dw" = (
/obj/structure/cable/yellow{
	icon_state = "4-8"
	},
/obj/machinery/atmospherics/pipe/simple/supply/hidden{
	dir = 4
	},
/turf/open/floor/plasteel,
/area/engineering/main)
"er" = (
/obj/structure/cable/yellow{
	icon_state = "4-8"
	},
/obj/machinery/atmospherics/pipe/simple/supply/hidden,
/turf/open/floor/plasteel,
/area/engineering/main)
"eP" = (
/obj/structure/cable/yellow{
	icon_state = "4-8"
	},
/turf/open/floor/plasteel,
/area/engineering/main)
"fq" = (
/obj/structure/cable/yellow{
	icon_state = "2-8"
	},
/obj/machinery/atmospherics/pipe/simple/supply/hidden{
	dir = 4
	},
/turf/open/floor/plasteel,
/area/engineering/main)
"gF" = (
/obj/structure/closet/crate,
/obj/item/stack/sheet/mineral/plasma{
	amount = 50
	},
/obj/item/stack/sheet/mineral/plasma{
	amount = 10
	},
/turf/open/floor/plasteel,
/area/engineering/main)
"ha" = (
/obj/machinery/atmospherics/components/unary/vent_pump/on{
	dir = 4
	},
/turf/open/floor/plasteel,
/area/engineering/main)
"hS" = (
/obj/machinery/atmospherics/components/unary/vent_scrubber/on{
	dir = 8
	},
/turf/open/floor/plasteel,
/area/engineering/main)
"il" = (
/obj/machinery/atmospherics/components/unary/vent_pump/on{
	dir = 1
	},
/turf/open/floor/plasteel,
/area/engineering/main)
"iB" = (
/obj/structure/cable/yellow{
	icon_state = "1-2"
	},
/obj/machinery/atmospherics/pipe/simple/supply/hidden{
	dir = 4
	},
/turf/open/floor/plasteel,
/area/engineering/main)
"iD" = (
/obj/effect/spawner/structure/window/plasma/reinforced,
/turf/open/floor/plating,
/area/engineering/main)
"jP" = (
/obj/structure/cable{
	icon_state = "4-8"
	},
/obj/structure/cable{
	icon_state = "0-4"
	},
/obj/machinery/power/terminal{
	dir = 1
	},
/obj/machinery/atmospherics/pipe/simple/supply/hidden{
	dir = 4
	},
/turf/open/floor/plasteel,
/area/engineering/main)
"ku" = (
/obj/structure/cable{
	icon_state = "0-8"
	},
/obj/machinery/power/terminal{
	dir = 1
	},
/turf/open/floor/plasteel,
/area/engineering/main)
"kz" = (
/obj/machinery/atmospherics/pipe/simple/supply/hidden{
	dir = 4
	},
/obj/machinery/atmospherics/pipe/simple/scrubbers/hidden,
/turf/open/floor/plasteel,
/area/engineering/main)
"kA" = (
/obj/machinery/atmospherics/pipe/manifold/scrubbers/hidden,
/obj/machinery/door/firedoor,
/obj/machinery/door/airlock/engineering/glass{
	name = "Supermatter Engine Room";
	req_access_txt = "10"
	},
/turf/open/floor/engine,
/area/engineering/main)
"lG" = (
/obj/structure/cable{
	icon_state = "4-8"
	},
/obj/machinery/atmospherics/pipe/simple/scrubbers/hidden{
	dir = 4
	},
/turf/open/floor/plasteel,
/area/engineering/main)
"mH" = (
/obj/structure/sign/poster/official/safety_eye_protection,
/turf/closed/wall/r_wall,
/area/engineering/main)
"mP" = (
/obj/machinery/power/smes{
	capacity = 9e+006;
	charge = 10000
	},
/obj/structure/cable/yellow{
	icon_state = "0-4"
	},
/obj/machinery/atmospherics/pipe/simple/scrubbers/hidden{
	dir = 4
	},
/turf/open/floor/plasteel,
/area/engineering/main)
"mU" = (
/obj/machinery/atmospherics/pipe/manifold/supply/hidden{
	dir = 1
	},
/obj/effect/spawner/structure/window/plasma/reinforced,
/turf/open/floor/plating,
/area/engineering/main)
"mW" = (
/obj/machinery/power/port_gen/pacman,
/obj/structure/cable{
	icon_state = "0-4"
	},
/obj/machinery/atmospherics/pipe/simple/supply/hidden{
	dir = 4
	},
/turf/open/floor/plasteel,
/area/engineering/main)
"nR" = (
/obj/machinery/atmospherics/pipe/simple/supply/hidden{
	dir = 4
	},
/obj/structure/cable/yellow{
	icon_state = "4-8"
	},
/obj/effect/spawner/structure/window/plasma/reinforced,
/turf/open/floor/plating,
/area/engineering/main)
"nZ" = (
/obj/structure/cable{
	icon_state = "0-4"
	},
/obj/machinery/power/terminal{
	dir = 1
	},
/obj/machinery/atmospherics/pipe/simple/supply/hidden{
	dir = 4
	},
/turf/open/floor/plasteel,
/area/engineering/main)
"oa" = (
/obj/structure/cable/yellow{
	icon_state = "1-2"
	},
/obj/machinery/atmospherics/pipe/simple/scrubbers/hidden{
	dir = 4
	},
/turf/open/floor/plasteel,
/area/engineering/main)
"ou" = (
/obj/machinery/atmospherics/pipe/simple/orange/visible{
	dir = 4
	},
/turf/open/floor/plasteel,
/area/engineering/main)
"oC" = (
/obj/machinery/atmospherics/pipe/manifold/scrubbers/hidden{
	dir = 1
	},
/obj/effect/spawner/structure/window/plasma/reinforced,
/turf/open/floor/plating,
/area/engineering/main)
"oS" = (
/obj/machinery/door/firedoor,
/obj/machinery/door/airlock/engineering/glass{
	name = "Supermatter Engine Room";
	req_access_txt = "10"
	},
/turf/open/floor/engine,
/area/engineering/main)
"pL" = (
/obj/structure/cable/yellow{
	icon_state = "4-8"
	},
/obj/machinery/atmospherics/pipe/manifold4w/scrubbers,
/turf/open/floor/plasteel,
/area/engineering/main)
"qc" = (
/obj/structure/cable/yellow{
	icon_state = "1-2"
	},
/turf/open/floor/plasteel,
/area/engineering/main)
"qo" = (
/obj/effect/spawner/structure/window/plasma/reinforced,
/obj/machinery/atmospherics/pipe/simple/orange/visible{
	dir = 4
	},
/turf/open/floor/plating,
/area/engineering/main)
"qH" = (
/obj/structure/cable/yellow{
	icon_state = "1-2"
	},
/obj/structure/cable/yellow{
	icon_state = "1-4"
	},
/obj/structure/cable/yellow{
	icon_state = "1-8"
	},
/turf/open/floor/plasteel,
/area/engineering/main)
"rU" = (
/obj/structure/cable/yellow{
	icon_state = "4-8"
	},
/obj/machinery/atmospherics/pipe/simple/scrubbers/hidden,
/turf/open/floor/plasteel,
/area/engineering/main)
"sj" = (
/obj/structure/cable{
	icon_state = "4-8"
	},
/obj/machinery/atmospherics/pipe/simple/scrubbers/hidden{
	dir = 4
	},
/obj/machinery/atmospherics/pipe/simple/supply/hidden,
/turf/open/floor/plasteel,
/area/engineering/main)
"sU" = (
/obj/structure/cable{
	icon_state = "4-8"
	},
/obj/structure/cable{
	icon_state = "0-4"
	},
/obj/machinery/power/terminal{
	dir = 1
	},
/turf/open/floor/plasteel,
/area/engineering/main)
"tb" = (
/obj/machinery/atmospherics/pipe/manifold4w/supply/hidden,
/turf/open/floor/plasteel,
/area/engineering/main)
"tf" = (
/obj/structure/cable{
	icon_state = "4-8"
	},
/obj/machinery/atmospherics/pipe/simple/scrubbers/hidden{
	dir = 5
	},
/turf/open/floor/plasteel,
/area/engineering/main)
"tw" = (
/obj/structure/lattice,
/turf/open/space/basic,
/area/space/nearstation)
"wt" = (
/obj/machinery/atmospherics/pipe/simple/scrubbers/hidden,
/obj/structure/closet/radiation,
/turf/open/floor/plasteel,
/area/engineering/main)
"xh" = (
/obj/structure/cable/yellow{
	icon_state = "4-8"
	},
/obj/machinery/atmospherics/pipe/simple/supply/hidden,
/obj/machinery/atmospherics/pipe/simple/scrubbers/hidden{
	dir = 4
	},
/turf/open/floor/plasteel,
/area/engineering/main)
"yf" = (
/turf/open/space/basic,
/area/space/nearstation)
"zS" = (
/turf/open/space/basic,
/area/space)
"AC" = (
/obj/machinery/atmospherics/pipe/simple/scrubbers/hidden{
	dir = 4
	},
/turf/open/floor/plasteel,
/area/engineering/main)
"AH" = (
/obj/structure/cable{
	icon_state = "4-8"
	},
/obj/machinery/door/firedoor,
/obj/machinery/door/airlock/engineering/glass{
	name = "Supermatter Engine Room";
	req_access_txt = "10"
	},
/turf/open/floor/engine,
/area/engineering/main)
"Bq" = (
/obj/structure/cable/yellow{
	icon_state = "1-2"
	},
/obj/structure/cable/yellow{
	icon_state = "1-4"
	},
/obj/structure/cable/yellow{
	icon_state = "1-8"
	},
/obj/machinery/atmospherics/pipe/simple/scrubbers/hidden{
	dir = 4
	},
/turf/open/floor/plasteel,
/area/engineering/main)
"Bz" = (
/obj/machinery/power/smes{
	capacity = 9e+006;
	charge = 10000
	},
/obj/structure/cable/yellow{
	icon_state = "4-8"
	},
/obj/machinery/atmospherics/pipe/simple/scrubbers/hidden{
	dir = 4
	},
/turf/open/floor/plasteel,
/area/engineering/main)
"Cb" = (
/obj/machinery/atmospherics/pipe/simple/supply/hidden{
	dir = 4
	},
/turf/open/floor/plasteel,
/area/engineering/main)
"Cx" = (
/obj/structure/cable/yellow{
	icon_state = "4-8"
	},
/obj/machinery/atmospherics/pipe/simple/scrubbers/hidden{
	dir = 4
	},
/turf/open/floor/plasteel,
/area/engineering/main)
"CH" = (
/obj/machinery/door/firedoor,
/obj/machinery/door/airlock/engineering/glass{
	name = "Supermatter Engine Room";
	req_access_txt = "10"
	},
/turf/open/floor/plasteel,
/area/engineering/main)
"DC" = (
/obj/structure/rack,
/obj/item/clothing/mask/gas{
	pixel_x = 3;
	pixel_y = 3
	},
/obj/item/clothing/mask/gas,
/obj/item/clothing/mask/gas{
	pixel_x = -3;
	pixel_y = -3
	},
/turf/open/floor/plasteel,
/area/engineering/main)
"Ei" = (
/obj/effect/mapping_helpers/airlock/cyclelink_helper{
	dir = 1
	},
/obj/machinery/door/airlock/external{
	name = "Engineering External Access";
	req_access_txt = "10;13"
	},
/turf/open/floor/plating,
/area/engineering/main)
"EL" = (
/turf/closed/wall,
/area/engineering/main)
"EW" = (
/obj/structure/cable/yellow{
	icon_state = "4-8"
	},
/obj/machinery/atmospherics/pipe/manifold/supply/hidden{
	dir = 1
	},
/turf/open/floor/plasteel,
/area/engineering/main)
"FG" = (
/obj/machinery/atmospherics/pipe/simple/orange/visible{
	dir = 10
	},
/turf/open/floor/plasteel,
/area/engineering/main)
"GB" = (
/obj/structure/cable/yellow{
	icon_state = "4-8"
	},
/obj/machinery/atmospherics/pipe/simple/supply/hidden{
	dir = 4
	},
/obj/machinery/atmospherics/pipe/simple/scrubbers/hidden,
/obj/effect/spawner/structure/window/plasma/reinforced,
/turf/open/floor/plating,
/area/engineering/main)
"GI" = (
/obj/machinery/firealarm{
	dir = 4;
	pixel_x = 24
	},
/turf/open/floor/plasteel,
/area/engineering/main)
"Hn" = (
/obj/machinery/atmospherics/components/unary/vent_scrubber/on{
	dir = 4;
	pixel_y = 5
	},
/turf/open/floor/plasteel,
/area/engineering/main)
"HN" = (
/obj/structure/cable{
	icon_state = "0-8"
	},
/obj/machinery/power/terminal{
	dir = 1
	},
/obj/machinery/atmospherics/pipe/simple/supply/hidden{
	dir = 4
	},
/turf/open/floor/plasteel,
/area/engineering/main)
"Jb" = (
/obj/machinery/power/smes{
	capacity = 9e+006;
	charge = 10000
	},
/obj/structure/cable/yellow{
	icon_state = "0-8"
	},
/obj/machinery/atmospherics/pipe/simple/scrubbers/hidden{
	dir = 4
	},
/turf/open/floor/plasteel,
/area/engineering/main)
"Jq" = (
/obj/machinery/power/port_gen/pacman,
/obj/structure/cable{
	icon_state = "0-8"
	},
/obj/machinery/atmospherics/pipe/simple/supply/hidden{
	dir = 4
	},
/turf/open/floor/plasteel,
/area/engineering/main)
"Ke" = (
/obj/structure/table,
/obj/item/storage/toolbox/mechanical{
	pixel_y = 5
	},
/obj/item/flashlight{
	pixel_x = 1;
	pixel_y = 5
	},
/obj/item/flashlight{
	pixel_x = 1;
	pixel_y = 5
	},
/turf/open/floor/plasteel,
/area/engineering/main)
"Kf" = (
/obj/machinery/atmospherics/pipe/manifold/scrubbers/hidden{
	dir = 1
	},
/turf/open/floor/plasteel,
/area/engineering/main)
"Kl" = (
/obj/machinery/power/port_gen/pacman,
/obj/structure/cable{
	icon_state = "0-4"
	},
/turf/open/floor/plasteel,
/area/engineering/main)
"KL" = (
/obj/structure/cable{
	icon_state = "0-4"
	},
/obj/machinery/power/terminal{
	dir = 1
	},
/turf/open/floor/plasteel,
/area/engineering/main)
"Le" = (
/obj/structure/lattice/catwalk,
/turf/open/space/basic,
/area/space/nearstation)
"LS" = (
/obj/machinery/power/smes{
	capacity = 9e+006;
	charge = 10000
	},
/obj/structure/cable/yellow{
	icon_state = "0-4"
	},
/turf/open/floor/plasteel,
/area/engineering/main)
"ME" = (
/obj/machinery/atmospherics/pipe/simple/scrubbers/hidden{
	dir = 9
	},
/obj/effect/spawner/structure/window/plasma/reinforced,
/turf/open/floor/plating,
/area/engineering/main)
"MP" = (
/turf/closed/wall/r_wall,
/area/engineering/main)
"Ne" = (
/obj/machinery/atmospherics/pipe/simple/supply/hidden,
/obj/effect/spawner/structure/window/plasma/reinforced,
/turf/open/floor/plating,
/area/engineering/main)
"Nz" = (
/obj/machinery/power/smes{
	capacity = 9e+006;
	charge = 10000
	},
/obj/structure/cable/yellow{
	icon_state = "4-8"
	},
/turf/open/floor/plasteel,
/area/engineering/main)
"ND" = (
/obj/effect/mapping_helpers/airlock/cyclelink_helper,
/obj/machinery/door/airlock/external{
	name = "Engineering External Access";
	req_access_txt = "10;13"
	},
/turf/open/floor/plating,
/area/engineering/main)
"NZ" = (
/obj/machinery/atmospherics/pipe/simple/orange/visible{
	dir = 5
	},
/turf/open/floor/plasteel,
/area/engineering/main)
"Oj" = (
/turf/closed/wall/r_wall,
/area/space/nearstation)
"Ok" = (
/turf/open/floor/plasteel,
/area/engineering/main)
"Ou" = (
/obj/machinery/power/smes{
	capacity = 9e+006;
	charge = 10000
	},
/obj/structure/cable/yellow{
	icon_state = "0-8"
	},
/turf/open/floor/plasteel,
/area/engineering/main)
"OU" = (
/obj/machinery/atmospherics/pipe/simple/orange/visible{
	dir = 4
	},
/obj/machinery/meter,
/turf/open/floor/plasteel,
/area/engineering/main)
"OX" = (
/obj/machinery/atmospherics/components/unary/vent_pump/on{
	dir = 4;
	pixel_y = 5
	},
/turf/open/floor/plasteel,
/area/engineering/main)
"Pi" = (
/obj/structure/cable{
	icon_state = "4-8"
	},
/obj/structure/cable{
	icon_state = "0-8"
	},
/obj/machinery/power/terminal{
	dir = 1
	},
/turf/open/floor/plasteel,
/area/engineering/main)
"QQ" = (
/obj/machinery/atmospherics/components/unary/vent_scrubber/on{
	dir = 1
	},
/turf/open/floor/plasteel,
/area/engineering/main)
"Rh" = (
/obj/structure/lattice,
/turf/open/space,
/area/space/nearstation)
"Rs" = (
/obj/structure/cable/yellow{
	icon_state = "4-8"
	},
/obj/machinery/atmospherics/pipe/manifold/supply/hidden,
/turf/open/floor/plasteel,
/area/engineering/main)
"Tk" = (
/obj/machinery/light/small{
	dir = 8
	},
/obj/structure/closet/emcloset/anchored,
/turf/open/floor/plating,
/area/engineering/main)
"TC" = (
/obj/machinery/atmospherics/components/unary/vent_pump/on{
	dir = 8
	},
/turf/open/floor/plasteel,
/area/engineering/main)
"TS" = (
/obj/machinery/atmospherics/pipe/simple/scrubbers/hidden,
/turf/open/floor/plasteel,
/area/engineering/main)
"Us" = (
/obj/structure/cable/yellow{
	icon_state = "1-4"
	},
/obj/structure/cable/yellow{
	icon_state = "1-8"
	},
/turf/open/floor/plasteel,
/area/engineering/main)
"UD" = (
/obj/machinery/power/port_gen/pacman,
/obj/structure/cable{
	icon_state = "0-8"
	},
/turf/open/floor/plasteel,
/area/engineering/main)
"VN" = (
/obj/structure/cable{
	icon_state = "4-8"
	},
/obj/structure/cable{
	icon_state = "0-8"
	},
/obj/machinery/power/terminal{
	dir = 1
	},
/obj/machinery/atmospherics/pipe/simple/supply/hidden{
	dir = 4
	},
/turf/open/floor/plasteel,
/area/engineering/main)
"Ys" = (
/obj/machinery/atmospherics/pipe/simple/supply/hidden,
/turf/open/floor/plasteel,
/area/engineering/main)
"YZ" = (
/obj/structure/lattice,
/obj/structure/grille,
/turf/open/space,
/area/space/nearstation)
"Zn" = (
/obj/structure/sign/warning/vacuum/external{
	pixel_x = 32
	},
/turf/open/floor/plating,
/area/engineering/main)
"ZT" = (
/turf/template_noop,
/area/template_noop)

(1,1,1) = {"
ZT
ZT
ZT
ZT
ZT
ZT
ZT
yf
Rh
yf
yf
Rh
yf
yf
Rh
yf
yf
yf
YZ
YZ
YZ
ZT
ZT
ZT
ZT
ZT
"}
(2,1,1) = {"
ZT
ZT
ZT
ZT
ZT
ZT
ZT
yf
tw
yf
yf
tw
yf
yf
tw
yf
yf
yf
YZ
Oj
YZ
ZT
ZT
ZT
ZT
ZT
"}
(3,1,1) = {"
ZT
ZT
ZT
ZT
ZT
ZT
ZT
tw
tw
tw
tw
tw
tw
tw
tw
tw
Rh
Rh
YZ
Oj
YZ
ZT
ZT
ZT
ZT
ZT
"}
(4,1,1) = {"
ZT
ZT
ZT
ZT
ZT
ZT
ZT
Le
tw
Le
Le
tw
Le
Le
tw
Le
Le
Le
YZ
Oj
YZ
ZT
ZT
ZT
ZT
ZT
"}
(5,1,1) = {"
ZT
ZT
ZT
ZT
ZT
ZT
ZT
tw
tw
tw
tw
tw
tw
tw
tw
tw
Rh
Rh
YZ
Oj
YZ
ZT
ZT
ZT
ZT
ZT
"}
(6,1,1) = {"
ZT
ZT
ZT
ZT
ZT
ZT
ZT
Le
tw
Le
Le
tw
Le
Le
tw
Le
Le
Le
YZ
Oj
YZ
ZT
ZT
ZT
ZT
ZT
"}
(7,1,1) = {"
ZT
ZT
ZT
ZT
EL
EL
MP
tw
tw
tw
tw
tw
tw
tw
tw
tw
Rh
Rh
YZ
Oj
YZ
yf
zS
zS
zS
zS
"}
(8,1,1) = {"
ZT
ZT
cP
Ke
EL
Tk
MP
Le
tw
Le
Le
tw
Le
Le
tw
Le
Le
Le
YZ
Oj
YZ
yf
zS
zS
zS
zS
"}
(9,1,1) = {"
ZT
ZT
dl
Ok
ND
Zn
Ei
tw
tw
tw
tw
tw
tw
tw
tw
tw
Rh
Rh
YZ
YZ
YZ
tw
zS
zS
zS
zS
"}
(10,1,1) = {"
ZT
nR
AH
iD
MP
MP
MP
MP
MP
MP
iD
iD
iD
MP
tw
yf
tw
yf
yf
Rh
yf
yf
zS
zS
zS
zS
"}
(11,1,1) = {"
oC
GB
tf
Ok
Ok
Ok
Ok
Ok
Ok
Ok
Ok
Ok
Ok
MP
tw
tw
tw
tw
aW
YZ
aW
yf
zS
zS
zS
zS
"}
(12,1,1) = {"
cS
dw
lG
Ok
ha
Ok
Ok
Hn
Ok
Ok
OX
Ok
Ok
MP
tw
yf
tw
yf
YZ
Oj
YZ
yf
zS
zS
zS
zS
"}
(13,1,1) = {"
ME
dw
lG
LS
nZ
LS
KL
mP
KL
LS
nZ
LS
KL
iD
tw
yf
tw
yf
YZ
Oj
YZ
yf
zS
zS
zS
zS
"}
(14,1,1) = {"
Ne
Rs
lG
Nz
jP
Nz
sU
Bz
sU
Nz
jP
Nz
sU
iD
tw
tw
tw
tw
YZ
Oj
YZ
Rh
zS
zS
zS
zS
"}
(15,1,1) = {"
MP
dw
lG
Nz
jP
Nz
sU
Bz
sU
Nz
jP
Nz
sU
iD
tw
yf
tw
yf
YZ
Oj
YZ
yf
zS
zS
zS
zS
"}
(16,1,1) = {"
MP
dw
lG
eP
Jq
eP
UD
Cx
UD
eP
Jq
eP
UD
MP
tw
tw
tw
tw
YZ
Oj
YZ
yf
zS
zS
zS
zS
"}
(17,1,1) = {"
oS
EW
sj
er
tb
er
Ys
xh
Ys
er
tb
er
il
iD
tw
yf
tw
yf
YZ
Oj
YZ
yf
zS
zS
zS
zS
"}
(18,1,1) = {"
iD
fq
oa
qH
iB
qH
qc
Bq
qc
qH
iB
Us
Ok
iD
tw
yf
tw
yf
YZ
Oj
YZ
yf
zS
zS
zS
zS
"}
(19,1,1) = {"
oS
Cb
Kf
rU
kz
rU
TS
pL
TS
rU
kz
rU
QQ
iD
tw
tw
tw
tw
YZ
Oj
YZ
yf
zS
zS
zS
zS
"}
(20,1,1) = {"
MP
Cb
AC
eP
mW
eP
Kl
Cx
Kl
eP
mW
eP
Kl
MP
tw
tw
tw
tw
YZ
Oj
YZ
yf
zS
zS
zS
zS
"}
(21,1,1) = {"
MP
Cb
AC
Nz
VN
Nz
Pi
Bz
Pi
Nz
VN
Nz
Pi
iD
tw
yf
tw
yf
YZ
Oj
YZ
yf
zS
zS
zS
zS
"}
(22,1,1) = {"
iD
Cb
AC
Nz
VN
Nz
Pi
Bz
Pi
Nz
VN
Nz
Pi
iD
tw
tw
tw
tw
YZ
Oj
YZ
Rh
zS
zS
zS
zS
"}
(23,1,1) = {"
iD
Cb
AC
Ou
HN
Ou
ku
Jb
ku
Ou
HN
Ou
ku
iD
tw
tw
tw
tw
YZ
Oj
YZ
yf
zS
zS
zS
zS
"}
(24,1,1) = {"
mH
Cb
AC
Ok
TC
Ok
Ok
hS
Ok
Ok
TC
Ok
Ok
MP
tw
tw
tw
tw
YZ
Oj
YZ
yf
zS
zS
zS
zS
"}
(25,1,1) = {"
iD
mU
AC
Ok
Ok
Ok
Ok
Ok
Ok
Ok
Ok
Ok
Ok
iD
tw
yf
tw
yf
YZ
YZ
YZ
yf
zS
zS
zS
zS
"}
(26,1,1) = {"
wt
av
kA
qo
MP
MP
MP
Ok
Ok
Ok
Ok
Ok
Ok
iD
tw
yf
tw
yf
yf
Rh
yf
yf
zS
zS
zS
zS
"}
(27,1,1) = {"
ZT
ZT
ZT
ou
DC
iD
Ok
Ok
Ok
Ok
Ok
Ok
Ok
iD
tw
yf
tw
tw
Rh
Rh
Rh
Rh
zS
zS
zS
zS
"}
(28,1,1) = {"
ZT
ZT
ZT
OU
Ok
CH
GI
Ok
gF
gF
gF
gF
gF
MP
tw
yf
Rh
yf
Rh
Oj
YZ
yf
zS
zS
zS
zS
"}
(29,1,1) = {"
ZT
ZT
ZT
FG
NZ
MP
MP
MP
MP
MP
iD
iD
iD
MP
Rh
Rh
Rh
Rh
Rh
Oj
YZ
yf
zS
zS
zS
zS
"}
