//MAP CONVERTED BY dmm2tgm.py THIS HEADER COMMENT PREVENTS RECONVERSION, DO NOT REMOVE
"av" = (
/obj/machinery/atmospherics/pipe/simple/scrubbers/hidden,
/obj/machinery/atmospherics/pipe/simple/supply/hidden{
	dir = 4
	},
/obj/effect/spawner/structure/window/plasma/reinforced,
/turf/open/floor/plating,
/area/engineering/main)
"cP" = (
/obj/structure/table,
/obj/item/clothing/gloves/color/yellow,
/obj/item/storage/toolbox/electrical{
	pixel_y = 5
	},
/turf/open/floor/plasteel,
/area/engineering/main)
"cS" = (
/obj/machinery/atmospherics/pipe/simple/scrubbers/hidden{
	dir = 4
	},
/obj/structure/sign/poster/official/safety_eye_protection,
/turf/closed/wall/r_wall,
/area/engineering/main)
"dl" = (
/obj/structure/cable{
	icon_state = "1-4"
	},
/turf/open/floor/plasteel,
/area/engineering/main)
"dw" = (
/obj/structure/lattice/catwalk,
/turf/open/space,
/area/space/nearstation)
"fq" = (
/obj/effect/spawner/structure/window/plasma/reinforced,
/obj/machinery/atmospherics/pipe/simple/scrubbers/visible,
/turf/open/floor/plating,
/area/engineering/main)
"hK" = (
/obj/structure/lattice/catwalk,
/turf/open/space/basic,
/area/space/nearstation)
"iD" = (
/obj/effect/spawner/structure/window/plasma/reinforced,
/turf/open/floor/plating,
/area/engineering/main)
"kA" = (
/obj/machinery/atmospherics/pipe/manifold/scrubbers/hidden,
/obj/machinery/door/firedoor,
/obj/machinery/door/airlock/engineering/glass{
	name = "Supermatter Engine Room";
	req_access_txt = "10"
	},
/turf/open/floor/engine,
/area/engineering/main)
"mH" = (
/obj/structure/sign/poster/official/safety_eye_protection,
/turf/closed/wall/r_wall,
/area/engineering/main)
"mU" = (
/obj/machinery/atmospherics/pipe/manifold/supply/hidden{
	dir = 1
	},
/obj/effect/spawner/structure/window/plasma/reinforced,
/turf/open/floor/plating,
/area/engineering/main)
"nR" = (
/obj/machinery/atmospherics/pipe/simple/supply/hidden{
	dir = 4
	},
/obj/structure/cable/yellow{
	icon_state = "4-8"
	},
/obj/effect/spawner/structure/window/plasma/reinforced,
/turf/open/floor/plating,
/area/engineering/main)
"ou" = (
/obj/machinery/atmospherics/pipe/simple/orange/visible{
	dir = 4
	},
/turf/open/floor/plasteel,
/area/engineering/main)
"oC" = (
/obj/machinery/atmospherics/pipe/manifold/scrubbers/hidden{
	dir = 1
	},
/obj/effect/spawner/structure/window/plasma/reinforced,
/turf/open/floor/plating,
/area/engineering/main)
"oS" = (
/obj/machinery/door/firedoor,
/obj/machinery/door/airlock/engineering/glass{
	name = "Supermatter Engine Room";
	req_access_txt = "10"
	},
/turf/open/floor/engine,
/area/engineering/main)
"qc" = (
/obj/machinery/atmospherics/pipe/simple/scrubbers/visible,
/turf/open/floor/plasteel,
/area/engineering/main)
"qo" = (
/obj/effect/spawner/structure/window/plasma/reinforced,
/obj/machinery/atmospherics/pipe/simple/orange/visible{
	dir = 4
	},
/turf/open/floor/plating,
/area/engineering/main)
"tw" = (
/obj/structure/lattice,
/turf/open/space/basic,
/area/space/nearstation)
"wt" = (
/obj/machinery/atmospherics/pipe/simple/scrubbers/hidden,
/obj/structure/closet/radiation,
/turf/open/floor/plasteel,
/area/engineering/main)
"yf" = (
/turf/open/space/basic,
/area/space/nearstation)
"zS" = (
/turf/open/space/basic,
/area/space)
"AH" = (
/obj/structure/cable{
	icon_state = "4-8"
	},
/obj/machinery/door/firedoor,
/obj/machinery/door/airlock/engineering/glass{
	name = "Supermatter Engine Room";
	req_access_txt = "10"
	},
/turf/open/floor/engine,
/area/engineering/main)
"CH" = (
/obj/machinery/door/firedoor,
/obj/machinery/door/airlock/engineering/glass{
	name = "Supermatter Engine Room";
	req_access_txt = "10"
	},
/turf/open/floor/plasteel,
/area/engineering/main)
"DC" = (
/obj/structure/rack,
/obj/item/clothing/mask/gas{
	pixel_x = 3;
	pixel_y = 3
	},
/obj/item/clothing/mask/gas,
/obj/item/clothing/mask/gas{
	pixel_x = -3;
	pixel_y = -3
	},
/turf/open/floor/plasteel,
/area/engineering/main)
"Ei" = (
/obj/effect/mapping_helpers/airlock/cyclelink_helper{
	dir = 1
	},
/obj/machinery/door/airlock/external{
	name = "Engineering External Access";
	req_access_txt = "10;13"
	},
/turf/open/floor/plating,
/area/engineering/main)
"EL" = (
/turf/closed/wall,
/area/engineering/main)
"FG" = (
/obj/machinery/atmospherics/pipe/simple/orange/visible{
	dir = 10
	},
/turf/open/floor/plasteel,
/area/engineering/main)
"GB" = (
/obj/structure/cable/yellow{
	icon_state = "4-8"
	},
/obj/machinery/atmospherics/pipe/simple/supply/hidden{
	dir = 4
	},
/obj/machinery/atmospherics/pipe/simple/scrubbers/hidden,
/obj/effect/spawner/structure/window/plasma/reinforced,
/turf/open/floor/plating,
/area/engineering/main)
"GI" = (
/obj/machinery/firealarm{
	dir = 4;
	pixel_x = 24
	},
/turf/open/floor/plasteel,
/area/engineering/main)
"Hn" = (
/obj/machinery/atmospherics/components/unary/outlet_injector/atmos/engine_waste{
	dir = 1
	},
/turf/open/floor/plating/airless,
/area/engineering/main)
"Ke" = (
/obj/structure/table,
/obj/item/storage/toolbox/mechanical{
	pixel_y = 5
	},
/obj/item/flashlight{
	pixel_x = 1;
	pixel_y = 5
	},
/obj/item/flashlight{
	pixel_x = 1;
	pixel_y = 5
	},
/turf/open/floor/plasteel,
/area/engineering/main)
"LS" = (
/obj/machinery/atmospherics/pipe/simple/scrubbers/visible,
/turf/open/floor/plating/airless,
/area/engineering/main)
"ME" = (
/obj/machinery/atmospherics/pipe/simple/scrubbers/hidden{
	dir = 9
	},
/obj/effect/spawner/structure/window/plasma/reinforced,
/turf/open/floor/plating,
/area/engineering/main)
"MP" = (
/turf/closed/wall/r_wall,
/area/engineering/main)
"Ne" = (
/obj/machinery/atmospherics/pipe/simple/supply/hidden,
/obj/effect/spawner/structure/window/plasma/reinforced,
/turf/open/floor/plating,
/area/engineering/main)
"ND" = (
/obj/effect/mapping_helpers/airlock/cyclelink_helper,
/obj/machinery/door/airlock/external{
	name = "Engineering External Access";
	req_access_txt = "10;13"
	},
/turf/open/floor/plating,
/area/engineering/main)
"NZ" = (
/obj/machinery/atmospherics/pipe/simple/orange/visible{
	dir = 5
	},
/turf/open/floor/plasteel,
/area/engineering/main)
"Oj" = (
/turf/closed/wall/r_wall,
/area/space/nearstation)
"Ok" = (
/turf/open/floor/plasteel,
/area/engineering/main)
"OU" = (
/obj/machinery/atmospherics/pipe/simple/orange/visible{
	dir = 4
	},
/obj/machinery/meter,
/turf/open/floor/plasteel,
/area/engineering/main)
"Rh" = (
/obj/structure/lattice,
/turf/open/space,
/area/space/nearstation)
"Tk" = (
/obj/machinery/light/small{
	dir = 8
	},
/obj/structure/closet/emcloset/anchored,
/turf/open/floor/plating,
/area/engineering/main)
"WB" = (
/obj/structure/lattice,
/obj/structure/grille,
/turf/open/space/basic,
/area/space/nearstation)
"YZ" = (
/obj/structure/lattice,
/obj/structure/grille,
/turf/open/space,
/area/space/nearstation)
"Zn" = (
/obj/structure/sign/warning/vacuum/external{
	pixel_x = 32
	},
/turf/open/floor/plating,
/area/engineering/main)
"ZT" = (
/turf/template_noop,
/area/template_noop)

(1,1,1) = {"
ZT
ZT
ZT
ZT
ZT
ZT
ZT
yf
Rh
yf
yf
Rh
yf
yf
Rh
yf
yf
yf
YZ
YZ
YZ
ZT
ZT
ZT
ZT
ZT
"}
(2,1,1) = {"
ZT
ZT
ZT
ZT
ZT
ZT
ZT
yf
tw
yf
yf
tw
yf
yf
tw
yf
yf
yf
YZ
Oj
YZ
ZT
ZT
ZT
ZT
ZT
"}
(3,1,1) = {"
ZT
ZT
ZT
ZT
ZT
ZT
ZT
tw
tw
tw
tw
tw
tw
tw
tw
tw
Rh
Rh
YZ
Oj
YZ
ZT
ZT
ZT
ZT
ZT
"}
(4,1,1) = {"
ZT
ZT
ZT
ZT
ZT
ZT
ZT
hK
tw
hK
hK
tw
hK
hK
tw
hK
hK
hK
YZ
Oj
YZ
ZT
ZT
ZT
ZT
ZT
"}
(5,1,1) = {"
ZT
ZT
ZT
ZT
ZT
ZT
ZT
tw
tw
tw
tw
tw
tw
tw
tw
tw
Rh
Rh
YZ
Oj
YZ
ZT
ZT
ZT
ZT
ZT
"}
(6,1,1) = {"
ZT
ZT
ZT
ZT
ZT
ZT
ZT
hK
tw
hK
hK
tw
hK
hK
tw
hK
hK
hK
YZ
Oj
YZ
ZT
ZT
ZT
ZT
ZT
"}
(7,1,1) = {"
ZT
ZT
ZT
ZT
EL
EL
MP
tw
tw
tw
tw
tw
tw
tw
tw
tw
Rh
Rh
YZ
Oj
YZ
yf
yf
yf
yf
zS
"}
(8,1,1) = {"
ZT
ZT
cP
Ke
EL
Tk
MP
hK
tw
hK
hK
tw
hK
hK
tw
hK
hK
hK
YZ
Oj
YZ
yf
yf
Rh
yf
yf
"}
(9,1,1) = {"
ZT
ZT
dl
Ok
ND
Zn
Ei
tw
tw
tw
tw
tw
tw
tw
tw
tw
Rh
Rh
YZ
YZ
YZ
tw
Rh
Rh
Rh
yf
"}
(10,1,1) = {"
ZT
nR
AH
iD
MP
MP
MP
MP
MP
MP
MP
MP
MP
MP
tw
yf
yf
yf
Rh
yf
yf
yf
yf
Rh
yf
yf
"}
(11,1,1) = {"
oC
GB
Ok
Ok
Ok
Ok
Ok
Ok
Ok
Ok
Ok
Ok
Ok
MP
MP
MP
MP
MP
MP
MP
MP
yf
WB
YZ
WB
yf
"}
(12,1,1) = {"
cS
Ok
Ok
Ok
Ok
Ok
Ok
Ok
Ok
Ok
Ok
Ok
Ok
Ok
Ok
Ok
Ok
Ok
Ok
Ok
MP
yf
YZ
Oj
YZ
yf
"}
(13,1,1) = {"
ME
Ok
Ok
Ok
Ok
Ok
Ok
Ok
Ok
Ok
Ok
Ok
Ok
Ok
Ok
Ok
Ok
Ok
Ok
Ok
MP
yf
YZ
Oj
YZ
yf
"}
(14,1,1) = {"
Ne
Ok
Ok
Ok
Ok
Ok
Ok
Ok
Ok
Ok
Ok
Ok
Ok
Ok
Ok
Ok
Ok
Ok
Ok
Ok
MP
Rh
YZ
Oj
YZ
Rh
"}
(15,1,1) = {"
MP
Ok
Ok
Ok
Ok
Ok
Ok
Ok
Ok
Ok
Ok
Ok
Ok
Ok
Ok
Ok
Ok
Ok
Ok
Ok
MP
yf
YZ
Oj
YZ
yf
"}
(16,1,1) = {"
MP
Ok
Ok
Ok
Ok
Ok
Ok
Ok
Ok
Ok
Ok
Ok
Ok
Ok
Ok
Ok
Ok
Ok
Ok
Ok
MP
Rh
YZ
Oj
YZ
yf
"}
(17,1,1) = {"
oS
Ok
Ok
Ok
Ok
Ok
Ok
Ok
Ok
Ok
Ok
Ok
Ok
Ok
Ok
Ok
Ok
Ok
Ok
Ok
MP
yf
YZ
Oj
YZ
yf
"}
(18,1,1) = {"
iD
Ok
Ok
Ok
Ok
Ok
Ok
Ok
Ok
Ok
Ok
Ok
Ok
Ok
Ok
Ok
Ok
Ok
Ok
Ok
MP
yf
YZ
Oj
YZ
yf
"}
(19,1,1) = {"
oS
Ok
Ok
Ok
Ok
Ok
Ok
Ok
Ok
Ok
Ok
Ok
Ok
Ok
Ok
Ok
Ok
Ok
Ok
Ok
MP
Rh
YZ
Oj
YZ
yf
"}
(20,1,1) = {"
MP
Ok
Ok
Ok
Ok
Ok
Ok
Ok
Ok
Ok
Ok
Ok
Ok
Ok
Ok
Ok
Ok
Ok
Ok
Ok
MP
Rh
YZ
Oj
YZ
yf
"}
(21,1,1) = {"
MP
Ok
Ok
Ok
Ok
Ok
Ok
Ok
Ok
Ok
Ok
Ok
Ok
Ok
Ok
Ok
Ok
Ok
Ok
Ok
MP
yf
YZ
Oj
YZ
yf
"}
(22,1,1) = {"
iD
Ok
Ok
Ok
Ok
Ok
Ok
Ok
Ok
Ok
Ok
Ok
Ok
Ok
Ok
Ok
Ok
Ok
Ok
Ok
MP
Rh
YZ
Oj
YZ
Rh
"}
(23,1,1) = {"
iD
Ok
Ok
Ok
Ok
Ok
Ok
Ok
Ok
Ok
Ok
Ok
Ok
Ok
Ok
Ok
Ok
Ok
Ok
Ok
MP
Rh
YZ
Oj
YZ
yf
"}
(24,1,1) = {"
mH
Ok
Ok
Ok
Ok
Ok
Ok
Ok
Ok
Ok
Ok
Ok
Ok
Ok
Ok
Ok
Ok
Ok
Ok
Ok
MP
Rh
YZ
Oj
YZ
yf
"}
(25,1,1) = {"
iD
mU
Ok
ou
Ok
Ok
Ok
Ok
Ok
Ok
Ok
Ok
Ok
MP
MP
MP
MP
MP
MP
MP
MP
yf
YZ
YZ
YZ
yf
"}
(26,1,1) = {"
wt
av
kA
qo
EL
MP
MP
Ok
Ok
Ok
Ok
Ok
qc
fq
LS
Hn
dw
yf
Rh
yf
yf
yf
yf
Rh
yf
yf
"}
(27,1,1) = {"
ZT
ZT
ZT
ou
DC
iD
Ok
Ok
Ok
Ok
Ok
Ok
Ok
MP
dw
dw
dw
Rh
Rh
Rh
Rh
tw
Rh
Rh
Rh
Rh
"}
(28,1,1) = {"
ZT
ZT
ZT
OU
Ok
CH
GI
Ok
Ok
Ok
Ok
Ok
Ok
MP
yf
yf
Rh
yf
Rh
Oj
YZ
yf
yf
Rh
yf
yf
"}
(29,1,1) = {"
ZT
ZT
ZT
FG
NZ
MP
MP
MP
MP
MP
iD
iD
iD
MP
Rh
Rh
Rh
Rh
Rh
Oj
YZ
yf
yf
Rh
yf
zS
"}
