//MAP CONVERTED BY dmm2tgm.py THIS HEADER COMMENT PREVENTS RECONVERSION, DO NOT REMOVE
"a" = (
/turf/template_noop,
/area/template_noop)
"b" = (
/turf/open/floor/plating/asteroid/airless,
/area/ruin/unpowered/no_grav)
"c" = (
/turf/closed/mineral,
/area/ruin/unpowered/no_grav)
"d" = (
/turf/closed/mineral/random/high_chance,
/area/ruin/unpowered/no_grav)
"e" = (
/obj/effect/decal/remains/human,
/obj/item/clothing/head/hardhat,
/obj/item/mining_scanner,
/turf/open/floor/plating/asteroid/airless,
/area/ruin/unpowered/no_grav)
"f" = (
/obj/item/pickaxe/diamond,
/turf/open/floor/plating/asteroid/airless,
/area/ruin/unpowered/no_grav)
"q" = (
/obj/item/trash/candle,
/turf/open/floor/plating/asteroid/airless,
/area/ruin/unpowered/no_grav)
"D" = (
/turf/closed/mineral/random/low_chance,
/area/ruin/unpowered/no_grav)
"L" = (
/obj/item/toy/plush/box,
/turf/open/floor/plating/asteroid/airless,
/area/ruin/unpowered/no_grav)
"X" = (
/obj/item/shovel,
/turf/open/floor/plating/asteroid/airless,
/area/ruin/unpowered/no_grav)

(1,1,1) = {"
a
a
b
a
a
a
a
a
b
D
D
D
c
b
a
a
a
a
"}
(2,1,1) = {"
a
a
a
a
a
a
a
b
b
d
d
D
D
D
D
D
a
a
"}
(3,1,1) = {"
b
b
a
b
b
b
a
b
b
d
d
D
D
d
d
d
b
a
"}
(4,1,1) = {"
b
b
b
b
c
c
b
b
D
d
d
D
D
d
d
d
b
a
"}
(5,1,1) = {"
b
b
c
c
c
c
c
D
D
D
D
D
D
d
d
d
c
a
"}
(6,1,1) = {"
a
b
c
c
D
D
D
D
D
c
D
c
D
D
D
D
b
a
"}
(7,1,1) = {"
a
a
b
b
D
d
D
c
q
b
b
b
c
c
D
D
b
a
"}
(8,1,1) = {"
a
b
b
c
D
D
D
b
L
b
f
b
q
D
D
b
b
b
"}
(9,1,1) = {"
a
b
b
D
D
c
c
b
q
e
b
b
b
c
D
c
b
b
"}
(10,1,1) = {"
a
b
b
c
D
D
q
b
X
b
b
q
c
D
D
D
c
b
"}
(11,1,1) = {"
a
b
b
c
D
D
c
c
b
b
c
c
c
D
d
d
b
b
"}
(12,1,1) = {"
a
a
b
d
d
D
c
D
D
D
D
D
D
D
d
d
b
b
"}
(13,1,1) = {"
a
a
b
d
d
D
D
D
d
D
D
D
D
D
c
b
b
a
"}
(14,1,1) = {"
a
a
b
d
d
c
D
D
D
D
D
c
c
b
b
b
a
a
"}
(15,1,1) = {"
b
a
b
c
c
c
D
D
D
c
c
c
c
b
a
a
a
b
"}
(16,1,1) = {"
a
a
b
b
b
c
D
D
D
D
c
b
b
a
a
a
a
a
"}
(17,1,1) = {"
a
a
a
b
b
c
D
d
d
D
c
b
b
a
a
a
a
a
"}
(18,1,1) = {"
a
a
a
a
a
a
D
d
d
a
a
a
a
a
a
a
a
a
"}
(19,1,1) = {"
a
a
b
a
a
a
a
a
a
a
a
a
b
a
a
a
b
a
"}
