//MAP CONVERTED BY dmm2tgm.py THIS HEADER COMMENT PREVENTS RECONVERSION, DO NOT REMOVE
"a" = (
/turf/template_noop,
/area/template_noop)
"b" = (
/turf/open/floor/plating/asteroid/airless,
/area/ruin/unpowered/no_grav)
"d" = (
/turf/closed/mineral/random/high_chance,
/area/ruin/unpowered/no_grav)
"i" = (
/turf/closed/mineral/random/low_chance,
/area/ruin/unpowered/no_grav)

(1,1,1) = {"
a
a
a
a
a
a
a
a
a
a
a
a
a
a
a
a
i
a
"}
(2,1,1) = {"
a
a
a
b
b
b
b
a
a
a
a
a
a
a
a
a
a
a
"}
(3,1,1) = {"
a
a
b
b
b
b
b
a
b
b
b
b
a
a
a
a
a
a
"}
(4,1,1) = {"
a
b
b
b
b
b
b
b
b
b
b
b
b
a
a
i
a
a
"}
(5,1,1) = {"
a
b
b
b
i
i
i
i
i
i
i
b
b
b
a
a
a
a
"}
(6,1,1) = {"
b
b
b
b
i
i
i
i
d
d
d
d
d
b
a
a
a
a
"}
(7,1,1) = {"
b
b
b
i
i
i
i
i
d
d
d
d
d
b
b
b
a
a
"}
(8,1,1) = {"
b
b
i
i
i
i
d
i
i
i
i
i
i
b
b
b
a
a
"}
(9,1,1) = {"
b
b
i
i
i
i
d
i
i
i
i
d
d
d
i
b
b
a
"}
(10,1,1) = {"
a
b
b
b
i
i
d
d
i
i
d
d
i
i
i
b
b
a
"}
(11,1,1) = {"
a
b
b
b
i
i
i
d
d
d
d
d
i
i
i
b
b
a
"}
(12,1,1) = {"
a
a
b
b
d
d
i
d
d
d
d
i
i
i
d
i
b
a
"}
(13,1,1) = {"
a
a
b
b
d
d
d
i
i
i
i
i
i
i
i
i
b
b
"}
(14,1,1) = {"
a
a
b
b
b
b
b
i
i
i
i
i
i
d
i
i
i
i
"}
(15,1,1) = {"
a
a
a
a
b
b
b
i
d
i
i
d
d
d
i
i
i
i
"}
(16,1,1) = {"
a
a
a
a
a
a
b
b
b
i
i
d
d
d
b
i
i
i
"}
(17,1,1) = {"
a
i
a
a
a
a
b
b
b
b
b
b
b
b
b
b
a
a
"}
(18,1,1) = {"
a
i
i
a
a
a
a
a
b
b
b
b
b
b
b
a
a
a
"}
(19,1,1) = {"
a
a
a
a
a
a
a
a
b
b
b
b
b
b
b
a
a
a
"}
(20,1,1) = {"
b
a
a
a
a
a
a
a
a
a
a
a
a
a
a
a
a
a
"}
