//MAP CONVERTED BY dmm2tgm.py THIS HEADER COMMENT PREVENTS RECONVERSION, DO NOT REMOVE
"a" = (
/turf/template_noop,
/area/template_noop)
"b" = (
/turf/closed/mineral,
/area/ruin/unpowered)
"c" = (
/turf/closed/mineral/random/high_chance,
/area/ruin/unpowered)
"d" = (
/turf/open/floor/plating/asteroid/airless,
/area/ruin/unpowered)
"g" = (
/turf/closed/mineral/random/low_chance,
/area/ruin/unpowered)

(1,1,1) = {"
a
a
a
a
a
a
a
a
a
a
a
a
a
a
a
a
a
a
a
a
a
a
a
a
a
a
a
a
a
a
g
c
c
c
a
a
a
a
"}
(2,1,1) = {"
a
a
a
a
a
a
a
a
a
a
a
a
a
a
a
a
a
a
a
a
a
a
a
a
a
a
a
a
a
a
g
c
c
c
c
g
a
a
"}
(3,1,1) = {"
a
a
a
a
a
g
g
c
c
a
a
a
a
a
a
a
a
a
a
a
a
a
a
a
a
a
a
a
d
d
d
g
c
c
c
g
g
b
"}
(4,1,1) = {"
a
a
a
a
a
g
g
g
g
g
a
a
a
a
a
a
a
a
a
a
a
a
a
a
a
a
d
d
d
d
d
g
g
g
g
g
g
b
"}
(5,1,1) = {"
a
a
a
c
c
c
g
g
g
g
g
g
g
a
a
a
a
a
a
a
a
a
a
a
a
a
d
d
d
d
d
g
g
g
g
g
g
b
"}
(6,1,1) = {"
a
a
a
c
c
c
c
g
g
g
g
g
g
c
c
c
a
a
a
a
a
a
a
a
g
g
d
d
d
d
g
g
g
g
g
g
g
b
"}
(7,1,1) = {"
a
a
a
c
c
c
c
g
g
g
g
g
g
c
c
c
a
a
a
a
a
a
a
g
d
d
d
d
g
c
c
c
c
g
g
g
g
b
"}
(8,1,1) = {"
a
a
g
c
c
c
g
g
g
d
d
d
d
g
g
g
a
a
a
a
a
a
a
d
d
d
g
g
g
c
c
c
c
g
g
c
c
a
"}
(9,1,1) = {"
a
a
g
g
g
g
g
d
d
d
d
d
d
d
d
g
a
a
a
a
a
a
g
d
d
g
g
g
g
c
c
c
c
g
g
c
c
a
"}
(10,1,1) = {"
a
g
g
g
g
g
c
d
d
d
a
a
d
d
d
c
a
a
a
a
a
a
d
d
d
g
c
c
c
c
c
c
c
g
g
g
g
a
"}
(11,1,1) = {"
a
g
g
g
g
g
d
d
a
a
a
a
d
d
d
g
a
a
a
a
a
a
d
d
g
g
c
c
c
c
d
d
d
g
g
g
a
a
"}
(12,1,1) = {"
a
g
g
g
g
d
d
a
a
a
a
a
a
a
a
a
a
a
a
a
a
a
d
d
c
c
c
d
d
d
d
d
d
g
g
g
g
a
"}
(13,1,1) = {"
a
g
g
g
c
d
d
a
a
a
a
a
a
a
a
a
a
a
a
a
a
g
d
d
c
c
g
d
d
c
d
d
d
g
g
g
g
a
"}
(14,1,1) = {"
a
g
g
g
c
d
a
a
a
a
a
a
a
a
a
a
a
a
a
a
a
d
d
g
c
c
g
d
d
g
d
d
d
g
g
g
g
a
"}
(15,1,1) = {"
g
g
g
d
d
d
a
a
a
a
a
g
a
a
a
a
a
a
a
a
a
d
d
g
c
c
g
g
g
g
d
d
d
g
g
g
g
a
"}
(16,1,1) = {"
g
g
g
d
d
d
a
a
a
a
a
a
a
a
a
a
a
a
a
a
a
d
d
g
c
c
g
g
d
d
d
d
d
g
g
g
g
b
"}
(17,1,1) = {"
g
g
g
d
d
d
a
a
a
a
a
a
a
a
a
g
g
g
a
a
a
d
d
g
g
c
g
g
d
d
d
d
g
g
g
g
c
c
"}
(18,1,1) = {"
c
c
d
d
d
a
a
g
g
a
a
a
a
a
a
g
g
g
g
a
a
d
d
g
c
g
g
d
d
d
c
g
g
c
c
g
c
c
"}
(19,1,1) = {"
c
c
d
d
d
a
a
g
g
g
a
a
a
a
g
g
g
g
g
a
a
g
d
g
g
g
g
d
d
d
g
g
g
c
c
g
c
c
"}
(20,1,1) = {"
c
c
d
d
d
a
a
g
g
g
a
a
a
a
g
g
g
a
a
a
a
g
d
d
d
g
g
d
d
d
d
g
g
g
g
g
c
c
"}
(21,1,1) = {"
c
c
g
d
d
a
a
a
a
a
a
a
a
a
a
a
a
a
a
a
a
g
d
d
d
c
c
c
g
d
d
g
g
g
c
g
g
b
"}
(22,1,1) = {"
g
g
g
d
d
a
a
a
a
a
a
a
a
a
a
a
a
a
a
a
a
a
d
d
d
c
c
c
g
d
d
g
c
c
g
g
g
b
"}
(23,1,1) = {"
a
g
g
d
d
d
a
a
a
a
a
a
a
a
g
a
a
a
a
a
a
a
a
a
d
d
d
d
d
d
d
g
g
g
g
g
g
a
"}
(24,1,1) = {"
a
g
g
c
d
d
d
d
a
a
a
a
a
a
a
a
a
a
a
a
a
a
a
a
g
c
d
d
d
d
d
g
g
g
g
g
g
a
"}
(25,1,1) = {"
a
g
g
g
g
d
d
d
a
a
a
a
a
a
a
a
a
a
a
a
a
a
a
a
a
a
d
d
d
d
d
c
c
g
a
a
a
a
"}
(26,1,1) = {"
a
g
g
g
g
d
d
d
a
a
a
a
a
a
a
a
a
a
a
a
a
a
a
a
a
a
a
a
a
a
a
a
a
a
a
a
a
a
"}
(27,1,1) = {"
a
g
g
c
c
g
g
g
a
a
a
g
g
a
a
a
a
a
a
a
a
g
a
a
a
a
a
a
a
a
a
a
a
a
a
a
a
a
"}
(28,1,1) = {"
a
a
g
c
c
g
g
g
g
g
g
g
g
a
a
a
a
d
d
d
g
g
g
a
a
a
a
a
a
a
a
a
a
a
a
a
a
a
"}
(29,1,1) = {"
a
a
a
a
a
a
g
g
g
g
g
a
a
a
a
a
a
d
d
d
c
g
g
a
a
a
a
a
a
a
a
a
a
a
a
a
a
a
"}
(30,1,1) = {"
a
a
a
a
a
a
a
a
a
a
a
a
a
a
a
a
a
d
d
d
g
g
g
g
g
g
a
a
a
a
a
a
a
a
a
a
a
a
"}
(31,1,1) = {"
a
a
a
a
a
a
a
a
a
a
a
a
a
a
a
d
d
d
d
d
g
g
g
g
g
g
g
a
a
a
a
a
a
a
a
a
a
a
"}
(32,1,1) = {"
a
a
a
a
a
a
a
a
a
a
a
a
a
a
a
d
d
d
g
g
g
g
g
g
g
g
c
a
a
a
a
a
a
a
a
a
a
a
"}
(33,1,1) = {"
a
a
a
a
a
a
a
a
a
a
a
a
a
a
d
d
d
d
d
d
d
c
c
c
g
g
c
g
a
a
a
a
a
a
a
g
g
a
"}
(34,1,1) = {"
a
a
a
a
a
a
a
a
a
a
a
a
a
a
d
d
d
d
d
d
d
d
d
d
g
g
g
g
a
a
a
a
a
a
g
c
g
a
"}
(35,1,1) = {"
a
a
a
a
a
a
a
a
a
a
a
g
g
g
d
d
d
g
g
g
d
d
d
d
g
g
g
c
a
a
a
a
a
g
c
c
g
a
"}
(36,1,1) = {"
a
a
a
a
a
a
a
a
a
a
g
c
c
c
g
g
g
g
g
g
g
d
d
g
g
g
a
a
a
a
a
a
a
g
g
g
a
a
"}
(37,1,1) = {"
a
a
a
a
a
a
a
a
a
g
c
c
c
c
g
g
g
g
g
g
c
c
g
g
g
g
a
a
a
a
a
a
a
a
a
a
a
a
"}
(38,1,1) = {"
a
a
a
a
a
a
a
a
a
a
a
c
c
c
g
a
a
a
g
g
g
g
g
a
a
a
a
a
a
a
a
a
a
a
a
a
a
a
"}
