//MAP CONVERTED BY dmm2tgm.py THIS HEADER COMMENT PREVENTS RECONVERSION, DO NOT REMOVE
"a" = (
/turf/template_noop,
/area/template_noop)
"b" = (
/turf/open/floor/plating/asteroid/airless,
/area/ruin/powered)
"c" = (
/turf/closed/mineral/random/high_chance,
/area/ruin/powered)
"d" = (
/turf/closed/wall/r_wall/rust,
/area/ruin/powered)
"e" = (
/obj/machinery/mecha_part_fabricator,
/obj/effect/decal/cleanable/dirt,
/turf/open/floor/plasteel,
/area/ruin/powered)
"f" = (
/turf/closed/wall/rust,
/area/ruin/powered)
"g" = (
/obj/structure/table,
/obj/effect/decal/cleanable/dirt,
/obj/item/stack/sheet/glass/fifty,
/obj/item/stack/sheet/metal/fifty,
/turf/open/floor/plasteel,
/area/ruin/powered)
"h" = (
/obj/machinery/mecha_part_fabricator,
/obj/machinery/light{
	dir = 1
	},
/obj/effect/decal/cleanable/dirt,
/turf/open/floor/plasteel,
/area/ruin/powered)
"i" = (
/obj/structure/table,
/obj/machinery/light{
	dir = 1
	},
/obj/effect/decal/cleanable/dirt,
/obj/item/stack/sheet/glass/fifty,
/obj/item/stack/sheet/metal/fifty,
/turf/open/floor/plasteel,
/area/ruin/powered)
"j" = (
/obj/structure/chair/sofa/right,
/obj/effect/decal/cleanable/dirt,
/turf/open/floor/plasteel,
/area/ruin/powered)
"k" = (
/turf/open/floor/plasteel,
/area/ruin/powered)
"l" = (
/obj/structure/chair/sofa/left,
/obj/effect/decal/cleanable/dirt,
/turf/open/floor/plasteel,
/area/ruin/powered)
"m" = (
/obj/machinery/computer/rdconsole/production{
	dir = 4
	},
/obj/effect/decal/cleanable/dirt,
/turf/open/floor/plasteel,
/area/ruin/powered)
"n" = (
/obj/effect/decal/cleanable/oil/streak,
/obj/effect/decal/cleanable/dirt,
/turf/open/floor/plasteel,
/area/ruin/powered)
"o" = (
/obj/effect/decal/cleanable/dirt,
/obj/effect/decal/cleanable/dirt,
/turf/open/floor/plasteel,
/area/ruin/powered)
"p" = (
/obj/effect/decal/cleanable/dirt,
/turf/open/floor/plasteel,
/area/ruin/powered)
"q" = (
/obj/machinery/light{
	dir = 8
	},
/obj/effect/decal/cleanable/dirt,
/obj/machinery/aug_manipulator,
/turf/open/floor/plasteel,
/area/ruin/powered)
"r" = (
/obj/structure/table,
/obj/effect/decal/cleanable/dirt,
/obj/item/organ/cyberimp/chest/reviver,
/obj/item/stack/sheet/mineral/gold{
	amount = 3
	},
/turf/open/floor/plasteel,
/area/ruin/powered)
"s" = (
/obj/structure/table,
/obj/effect/decal/cleanable/dirt,
/obj/item/organ/cyberimp/arm/surgery,
/turf/open/floor/plasteel,
/area/ruin/powered)
"t" = (
/obj/structure/table,
/obj/effect/decal/cleanable/dirt,
/obj/item/storage/backpack/duffelbag/med/surgery,
/turf/open/floor/plasteel,
/area/ruin/powered)
"u" = (
/obj/machinery/light{
	dir = 4
	},
/obj/effect/decal/cleanable/dirt,
/turf/open/floor/plasteel,
/area/ruin/powered)
"v" = (
/obj/machinery/porta_turret/syndicate/energy{
	mode = 1
	},
/turf/closed/wall/r_wall/rust,
/area/ruin/powered)
"w" = (
/obj/effect/decal/cleanable/dirt,
/obj/machinery/computer/mech_bay_power_console{
	dir = 4
	},
/turf/open/floor/plasteel,
/area/ruin/powered)
"x" = (
/obj/effect/decal/cleanable/oil,
/obj/effect/decal/cleanable/dirt,
/turf/open/floor/plasteel,
/area/ruin/powered)
"y" = (
/obj/effect/decal/cleanable/dirt,
/obj/effect/decal/cleanable/dirt,
/obj/machinery/atmospherics/components/unary/vent_scrubber/on/layer1,
/turf/open/floor/plasteel,
/area/ruin/powered)
"z" = (
/obj/structure/table,
/obj/effect/decal/cleanable/dirt,
/obj/item/storage/belt/utility/full,
/obj/item/clothing/glasses/welding,
/turf/open/floor/plasteel,
/area/ruin/powered)
"A" = (
/obj/structure/table,
/obj/effect/decal/cleanable/dirt,
/obj/item/mmi,
/turf/open/floor/plasteel,
/area/ruin/powered)
"B" = (
/obj/structure/table/optable,
/obj/effect/decal/cleanable/dirt,
/turf/open/floor/plasteel,
/area/ruin/powered)
"C" = (
/obj/machinery/mech_bay_recharge_port,
/obj/effect/decal/cleanable/dirt,
/turf/open/floor/plasteel,
/area/ruin/powered)
"D" = (
/obj/effect/decal/cleanable/dirt,
/turf/open/floor/mech_bay_recharge_floor,
/area/ruin/powered)
"E" = (
/obj/machinery/computer/operating{
	dir = 1
	},
/obj/effect/decal/cleanable/dirt,
/turf/open/floor/plasteel,
/area/ruin/powered)
"F" = (
/obj/structure/table,
/obj/effect/decal/cleanable/dirt,
/obj/item/autosurgeon{
	desc = "A device that automatically inserts an implant or organ into the user without the hassle of extensive surgery. It has a slot to insert an organ of implant. But this rusted version looks like it could only manage one implant....";
	name = "rusted autosurgeon";
	uses = 1
	},
/turf/open/floor/plasteel,
/area/ruin/powered)
"G" = (
/obj/machinery/light,
/obj/effect/decal/cleanable/dirt,
/obj/machinery/airalarm{
	dir = 1;
	pixel_y = -22
	},
/turf/open/floor/plasteel,
/area/ruin/powered)
"H" = (
/obj/effect/decal/cleanable/oil,
/obj/machinery/light,
/obj/effect/decal/cleanable/dirt,
/turf/open/floor/plasteel,
/area/ruin/powered)
"I" = (
/obj/machinery/door/airlock/external/glass,
/turf/open/floor/plasteel,
/area/ruin/powered)
"J" = (
/obj/machinery/atmospherics/components/unary/outlet_injector/on/layer1{
	dir = 4
	},
/turf/open/floor/plating/asteroid/airless,
/area/ruin/powered)
"K" = (
/obj/machinery/atmospherics/pipe/simple/scrubbers/hidden/layer1{
	dir = 4
	},
/turf/closed/mineral/random/high_chance,
/area/ruin/powered)
"L" = (
/obj/machinery/atmospherics/pipe/simple/scrubbers/hidden/layer1{
	dir = 4
	},
/turf/closed/wall/r_wall/rust,
/area/ruin/powered)
"M" = (
/obj/structure/mecha_wreckage/ripley,
/obj/effect/decal/cleanable/dirt,
/obj/machinery/atmospherics/pipe/simple/scrubbers/hidden/layer1{
	dir = 4
	},
/turf/open/floor/plasteel,
/area/ruin/powered)
"N" = (
/obj/effect/decal/cleanable/dirt,
/obj/machinery/atmospherics/pipe/simple/scrubbers/hidden/layer1{
	dir = 4
	},
/turf/open/floor/plasteel,
/area/ruin/powered)
"O" = (
/obj/machinery/turretid{
	lethal = 1;
	pixel_y = -25;
	req_access = null
	},
/obj/effect/decal/cleanable/dirt,
/obj/machinery/atmospherics/pipe/simple/cyan/hidden{
	dir = 5
	},
/turf/open/floor/plasteel,
/area/ruin/powered)
"P" = (
/obj/effect/decal/cleanable/dirt,
/obj/machinery/atmospherics/components/unary/vent_pump/on,
/turf/open/floor/plasteel,
/area/ruin/powered)
"Q" = (
/obj/effect/decal/cleanable/dirt,
/obj/effect/decal/cleanable/dirt,
/obj/machinery/atmospherics/pipe/simple/scrubbers/hidden/layer1{
	dir = 1
	},
/turf/open/floor/plasteel,
/area/ruin/powered)
"R" = (
/obj/effect/decal/cleanable/dirt,
/obj/machinery/atmospherics/pipe/simple/cyan/hidden,
/turf/open/floor/plasteel,
/area/ruin/powered)
"S" = (
/obj/effect/decal/cleanable/dirt,
/obj/machinery/atmospherics/pipe/simple/scrubbers/hidden/layer1{
	dir = 9
	},
/turf/open/floor/plasteel,
/area/ruin/powered)
"T" = (
/obj/effect/decal/cleanable/dirt,
/obj/machinery/atmospherics/components/unary/tank/air{
	dir = 8
	},
/turf/open/floor/plasteel,
/area/ruin/powered)
"U" = (
/obj/machinery/door/airlock/external/glass,
/obj/structure/fans/tiny,
/turf/open/floor/plasteel,
/area/ruin/powered)
"V" = (
/obj/effect/decal/cleanable/dirt,
/obj/structure/reagent_dispensers/fueltank,
/turf/open/floor/plasteel,
/area/ruin/powered)

(1,1,1) = {"
a
a
a
a
a
a
a
a
a
a
a
a
a
a
a
a
a
a
a
a
"}
(2,1,1) = {"
a
a
a
a
a
a
b
b
b
b
a
a
a
a
a
a
a
a
a
a
"}
(3,1,1) = {"
a
a
a
a
b
b
c
c
c
c
J
b
b
a
a
a
a
a
a
a
"}
(4,1,1) = {"
a
a
a
b
c
c
c
c
c
c
K
c
b
b
b
a
a
a
a
a
"}
(5,1,1) = {"
a
a
b
c
c
d
d
d
d
d
L
d
c
c
b
a
a
a
a
a
"}
(6,1,1) = {"
a
a
b
c
d
d
m
q
w
C
M
d
d
c
b
a
a
a
a
a
"}
(7,1,1) = {"
a
b
b
c
d
e
n
o
x
D
N
f
d
v
b
a
a
a
a
a
"}
(8,1,1) = {"
a
b
c
c
d
g
o
o
y
Q
S
I
k
U
b
a
a
a
a
a
"}
(9,1,1) = {"
a
b
c
c
d
h
p
r
z
o
G
f
f
d
b
a
a
a
a
a
"}
(10,1,1) = {"
a
b
c
c
d
i
p
s
A
o
H
f
f
d
b
a
a
a
a
a
"}
(11,1,1) = {"
a
b
c
c
d
j
p
t
F
o
p
I
k
U
b
a
a
a
a
a
"}
(12,1,1) = {"
a
b
c
c
d
l
p
p
P
R
O
f
d
v
b
b
a
a
a
a
"}
(13,1,1) = {"
a
b
b
c
d
d
V
u
B
E
T
d
d
c
c
b
a
a
a
a
"}
(14,1,1) = {"
a
a
b
c
c
d
d
d
d
d
d
d
c
c
c
b
a
a
a
a
"}
(15,1,1) = {"
a
a
a
b
c
c
c
c
c
c
c
c
c
c
b
b
a
a
a
a
"}
(16,1,1) = {"
a
a
a
b
b
b
b
c
c
c
c
b
b
b
b
a
a
a
a
a
"}
(17,1,1) = {"
a
a
a
a
a
a
b
b
b
b
b
b
a
a
a
a
a
a
a
a
"}
(18,1,1) = {"
a
a
a
a
a
a
a
a
a
a
a
a
a
a
a
a
a
a
a
a
"}
(19,1,1) = {"
a
a
a
a
a
a
a
a
a
a
a
a
a
a
a
a
a
a
a
a
"}
(20,1,1) = {"
a
a
a
a
a
a
a
a
a
a
a
a
a
a
a
a
a
a
a
a
"}
