//MAP CONVERTED BY dmm2tgm.py THIS HEADER COMMENT PREVENTS RECONVERSION, DO NOT REMOVE
"aa" = (
/turf/template_noop,
/area/template_noop)
"ab" = (
/turf/closed/mineral/random/low_chance,
/area/ruin/unpowered)
"ad" = (
/obj/machinery/hydroponics/soil,
/turf/open/floor/plating/asteroid,
/area/ruin/powered)
"ae" = (
/turf/closed/wall/mineral/titanium,
/area/ruin/powered)
"af" = (
/obj/effect/spawner/structure/window/shuttle,
/turf/open/floor/mineral/titanium,
/area/ruin/powered)
"ag" = (
/obj/effect/turf_decal/bot,
/obj/effect/decal/cleanable/dirt,
/obj/structure/closet,
/obj/effect/spawner/lootdrop/maintenance{
	lootcount = 8;
	name = "8maintenance loot spawner"
	},
/turf/open/floor/mineral/titanium,
/area/ruin/powered)
"ah" = (
/obj/structure/table/wood,
/obj/item/shovel,
/turf/open/floor/plating/asteroid,
/area/ruin/powered)
"ai" = (
/obj/structure/lattice,
/turf/template_noop,
/area/template_noop)
"aj" = (
/obj/machinery/computer/cryopod,
/turf/closed/wall/mineral/titanium,
/area/ruin/powered)
"ak" = (
/obj/structure/fluff/empty_cryostasis_sleeper,
/turf/open/floor/mineral/titanium,
/area/ruin/powered)
"al" = (
/obj/machinery/status_display/shuttle,
/turf/closed/wall/mineral/titanium,
/area/ruin/powered)
"am" = (
/turf/open/floor/plating/asteroid,
/area/ruin/powered)
"an" = (
/turf/open/floor/mineral/titanium,
/area/ruin/powered)
"ao" = (
/obj/structure/chair/comfy/shuttle{
	dir = 8
	},
/turf/open/floor/mineral/titanium,
/area/ruin/powered)
"ap" = (
/obj/machinery/light{
	dir = 1
	},
/turf/open/floor/mineral/titanium,
/area/ruin/powered)
"aq" = (
/obj/machinery/computer{
	desc = "A computer long since rendered non-functional due to lack of maintenance. Spitting out error messages.";
	dir = 4;
	name = "Broken Computer"
	},
/turf/open/floor/mineral/titanium,
/area/ruin/powered)
"ar" = (
/turf/closed/wall/mineral/wood,
/area/ruin/powered)
"as" = (
/obj/machinery/light,
/turf/open/floor/mineral/titanium,
/area/ruin/powered)
"at" = (
/obj/structure/extinguisher_cabinet{
	pixel_x = 5;
	pixel_y = -32
	},
/obj/machinery/portable_atmospherics/pump,
/obj/effect/turf_decal/bot,
/obj/effect/decal/cleanable/dirt,
/turf/open/floor/mineral/titanium,
/area/ruin/powered)
"au" = (
/obj/item/seeds/tower,
/obj/item/seeds/tower,
/obj/item/seeds/tower,
/turf/open/floor/plating/asteroid,
/area/ruin/powered)
"av" = (
/obj/structure/table/wood,
/obj/item/reagent_containers/food/snacks/meat/slab/human/mutant/skeleton{
	pixel_x = 6;
	pixel_y = 9
	},
/obj/item/reagent_containers/food/snacks/meat/slab/human/mutant/skeleton,
/obj/item/reagent_containers/food/snacks/meat/slab/human/mutant/skeleton{
	pixel_x = -5;
	pixel_y = 6
	},
/turf/open/floor/plating/asteroid,
/area/ruin/powered)
"aw" = (
/obj/item/stack/sheet/mineral/wood,
/obj/item/stack/sheet/mineral/wood,
/obj/item/stack/sheet/mineral/wood,
/obj/item/stack/sheet/mineral/wood,
/obj/item/stack/sheet/mineral/wood,
/turf/open/floor/plating/asteroid,
/area/ruin/powered)
"ax" = (
/obj/item/spear,
/turf/open/floor/plating/asteroid,
/area/ruin/powered)
"ay" = (
/obj/item/grown/log,
/obj/item/grown/log,
/turf/open/floor/plating/asteroid,
/area/ruin/powered)
"az" = (
/obj/structure/table/wood,
/obj/item/storage/bag/plants/portaseeder,
/turf/open/floor/plating/asteroid,
/area/ruin/powered)
"aA" = (
/turf/open/floor/plating/asteroid/airless,
/area/ruin/unpowered)
"aB" = (
/obj/item/seeds/banana,
/obj/item/seeds/banana,
/turf/open/floor/plating/asteroid,
/area/ruin/powered)
"aC" = (
/obj/effect/mob_spawn/human/clown/corpse,
/obj/structure/fans/tiny/invisible,
/turf/open/floor/plating/asteroid,
/area/ruin/powered)
"aD" = (
/obj/item/mining_scanner,
/turf/open/floor/plating/asteroid,
/area/ruin/powered)
"aE" = (
/turf/open/floor/plating/asteroid/airless,
/area/ruin/powered)
"aF" = (
/obj/machinery/power/port_gen/pacman{
	active = 1;
	anchored = 1;
	sheets = 10
	},
/obj/effect/turf_decal/bot,
/obj/effect/decal/cleanable/dirt,
/obj/effect/turf_decal/stripes/line,
/turf/open/floor/mineral/titanium,
/area/ruin/powered)
"aG" = (
/obj/structure/sink/puddle,
/turf/open/floor/plating/asteroid,
/area/ruin/powered)
"aH" = (
/obj/structure/table/wood,
/obj/item/storage/firstaid/regular,
/turf/open/floor/plating/asteroid,
/area/ruin/powered)
"aI" = (
/obj/effect/mob_spawn/human/corpse/assistant,
/turf/template_noop,
/area/template_noop)
"aJ" = (
/obj/structure/table/wood,
/obj/item/storage/bag/ore,
/turf/open/floor/plating/asteroid,
/area/ruin/powered)
"aK" = (
/obj/structure/reagent_dispensers/fueltank,
/turf/open/floor/plating/asteroid,
/area/ruin/powered)
"aL" = (
/obj/structure/table/wood,
/obj/item/storage/toolbox/mechanical,
/obj/item/clothing/head/welding,
/turf/open/floor/plating/asteroid,
/area/ruin/powered)
"aM" = (
/mob/living/simple_animal/hostile/carp,
/turf/template_noop,
/area/template_noop)
"aN" = (
/obj/structure/mineral_door/sandstone,
/turf/open/floor/plating/asteroid,
/area/ruin/powered)
"aO" = (
/mob/living/simple_animal/hostile/carp,
/turf/open/floor/plating/asteroid/airless,
/area/ruin/unpowered)
"aP" = (
/obj/item/stack/ore/gold,
/turf/open/floor/plating/asteroid,
/area/ruin/powered)
"aQ" = (
/obj/item/circuitboard/machine/circuit_imprinter,
/turf/open/floor/plating/asteroid,
/area/ruin/powered)
"aR" = (
/obj/item/stack/ore/iron,
/turf/open/floor/plating/asteroid,
/area/ruin/powered)
"aS" = (
/turf/closed/wall/mineral/iron,
/area/ruin/powered)
"aT" = (
/obj/item/stack/ore/iron,
/obj/item/stack/ore/iron,
/turf/open/floor/plating/asteroid,
/area/ruin/powered)
"aU" = (
/obj/structure/table/wood,
/obj/item/reagent_containers/food/snacks/meat/slab/human{
	pixel_x = 3;
	pixel_y = 3
	},
/obj/item/reagent_containers/food/snacks/meat/slab/human,
/turf/open/floor/plating/asteroid,
/area/ruin/powered)
"aV" = (
/obj/item/clothing/suit/space/orange,
/turf/template_noop,
/area/template_noop)
"aW" = (
/obj/item/clothing/head/helmet/space/orange,
/turf/template_noop,
/area/template_noop)
"aX" = (
/mob/living/simple_animal/hostile/carp/megacarp,
/turf/template_noop,
/area/template_noop)
"aY" = (
/obj/effect/mob_spawn/human/hermit{
	flavour_text = "<span class='big bold'>You've been late to awaken from your cryo slumber. Blasted machine, you set it to 10 days not 10 weeks!</span><b> Where have the others gone while we were out? Did they manage to survive? These thoughts are dispelled by yet another recollection of how you got here... ";
	job_description = "Space Hermit"
	},
/turf/open/floor/mineral/titanium,
/area/ruin/powered)
"aZ" = (
/turf/closed/mineral/random/low_chance,
/area/ruin/powered)
"bb" = (
/turf/closed/mineral/random,
/area/ruin/powered)
"bc" = (
/obj/structure/table/wood,
/obj/item/vending_refill/snack,
/turf/open/floor/plating/asteroid,
/area/ruin/powered)
"bd" = (
/obj/structure/shuttle/engine/propulsion/right{
	dir = 4
	},
/turf/closed/wall/mineral/titanium,
/area/ruin/powered)
"be" = (
/obj/structure/chair/wood/normal{
	dir = 1
	},
/turf/open/floor/plating/asteroid,
/area/ruin/powered)
"bf" = (
/obj/machinery/door/airlock/wood,
/turf/open/floor/plating/asteroid,
/area/ruin/powered)
"bg" = (
/obj/item/stock_parts/matter_bin/adv,
/turf/open/floor/plating/asteroid,
/area/ruin/powered)
"bh" = (
/obj/item/circuitboard/machine/autolathe,
/turf/open/floor/mineral/titanium,
/area/ruin/powered)
"bi" = (
/obj/item/stock_parts/manipulator/pico,
/turf/open/floor/plating/asteroid,
/area/ruin/powered)
"bj" = (
/obj/item/holosign_creator/atmos,
/turf/open/floor/plating/asteroid,
/area/ruin/powered)
"bk" = (
/obj/structure/holosign/barrier/atmos,
/turf/open/floor/plating/asteroid,
/area/ruin/powered)
"bl" = (
/obj/machinery/door/airlock/titanium{
	name = "Escape Pod Airlock"
	},
/turf/open/floor/mineral/titanium,
/area/ruin/powered)
"bm" = (
/obj/item/flashlight/lamp,
/obj/structure/table/wood,
/turf/open/floor/plating/asteroid,
/area/ruin/powered)
"bn" = (
/obj/structure/table/wood,
/obj/item/paper/crumpled{
	info = "</b><br><br>So this is it, I guess.. Always thought I'd go out doing something stupid, but.. not like this.<br>Should anyone find this note, tell Jeremy Clarke he can kiss my ass. Launching the pod unprepared like that..<br>Well. Now that I'm keeling over here, I guess I should write how I came to be the last one standing here.<br>Four of us took this pod.. only three of us woke up though.. fourth pod is locked from the inside, we couldn't figure out how to get it open.<br>Me and the clown set up a farm s'we can survive at least a while.. though, he didn't seem to understand that man cannot live on banana alone.<br>Had a bunch of circuits on him for some reason when he eventually passed, whispered to me something about a chem dispenser.. I.. don't know what he meant by that. I was never good with machinary. Maybe he wanted space lube?<br>The assistant that we gave the space suit to go out and find help never came back.. I'm betting he found salvation and left us behind.. never can trust those grubby greytiders."
	},
/obj/item/pen,
/obj/item/stock_parts/cell/hyper,
/turf/open/floor/plating/asteroid,
/area/ruin/powered)
"bo" = (
/obj/item/grown/bananapeel,
/turf/open/floor/plating/asteroid,
/area/ruin/powered)
"bp" = (
/obj/effect/mob_spawn/human/corpse/cargo_tech,
/obj/structure/fans/tiny/invisible,
/turf/open/floor/plating/asteroid,
/area/ruin/powered)
"bq" = (
/obj/item/clothing/glasses/meson,
/turf/open/floor/plating/asteroid,
/area/ruin/powered)
"br" = (
/obj/effect/decal/cleanable/oil{
	icon_state = "floor5"
	},
/turf/open/floor/mineral/titanium,
/area/ruin/powered)
"bs" = (
/obj/item/flashlight/lamp/bananalamp,
/turf/open/floor/plating/asteroid,
/area/ruin/powered)
"bC" = (
/obj/item/pickaxe/titanium,
/turf/open/floor/plating/asteroid,
/area/ruin/powered)
"fc" = (
/obj/item/stack/ore/iron,
/obj/item/stack/sheet/mineral/plasma,
/obj/item/stack/sheet/mineral/plasma,
/turf/open/floor/plating/asteroid,
/area/ruin/powered)
"fp" = (
/turf/closed/mineral/random/high_chance,
/area/ruin/powered)
"jx" = (
/turf/closed/mineral/silver,
/area/ruin/powered)
"ma" = (
/obj/item/stack/ore/iron,
/obj/item/stack/ore/iron,
/obj/item/stack/ore/iron,
/turf/open/floor/plating/asteroid,
/area/ruin/powered)
"mr" = (
/obj/structure/chair/comfy/shuttle{
	dir = 8
	},
/obj/effect/mob_spawn/human/skeleton,
/turf/open/floor/mineral/titanium,
/area/ruin/powered)
"nc" = (
/turf/closed/mineral/bscrystal,
/area/ruin/powered)
"nl" = (
/obj/structure/closet/emcloset,
/obj/effect/turf_decal/bot,
/turf/open/floor/mineral/titanium,
/area/ruin/powered)
"oR" = (
/obj/structure/cable{
	icon_state = "2-8"
	},
/turf/open/floor/plating/asteroid,
/area/ruin/powered)
"wU" = (
/obj/machinery/portable_atmospherics/canister/air,
/obj/effect/turf_decal/bot,
/obj/effect/decal/cleanable/dirt,
/turf/open/floor/mineral/titanium,
/area/ruin/powered)
"zs" = (
/obj/structure/reagent_dispensers/watertank/high,
/obj/effect/turf_decal/bot,
/obj/effect/turf_decal/stripes/line{
	dir = 10
	},
/turf/open/floor/mineral/titanium,
/area/ruin/powered)
"CY" = (
/obj/machinery/portable_atmospherics/canister/air,
/obj/effect/turf_decal/bot,
/turf/open/floor/mineral/titanium,
/area/ruin/powered)
"DH" = (
/obj/structure/chair/comfy/shuttle{
	dir = 8
	},
/obj/effect/decal/cleanable/vomit/old,
/turf/open/floor/mineral/titanium,
/area/ruin/powered)
"Ft" = (
/obj/structure/reagent_dispensers/fueltank/high,
/obj/effect/turf_decal/bot,
/obj/effect/decal/cleanable/dirt,
/obj/effect/turf_decal/stripes/line{
	dir = 8
	},
/turf/open/floor/mineral/titanium,
/area/ruin/powered)
"HK" = (
/obj/structure/cable{
	icon_state = "1-4"
	},
/turf/open/floor/plating/asteroid,
/area/ruin/powered)
"HP" = (
/obj/machinery/portable_atmospherics/scrubber,
/obj/effect/turf_decal/bot,
/turf/open/floor/mineral/titanium,
/area/ruin/powered)
"Iy" = (
/obj/item/clothing/suit/hazardvest{
	desc = "A high-visibility lifejacket complete with whistle and slot for oxygen tanks.";
	name = "emergency lifejacket"
	},
/obj/item/clothing/suit/hazardvest{
	desc = "A high-visibility lifejacket complete with whistle and slot for oxygen tanks.";
	name = "emergency lifejacket"
	},
/obj/item/clothing/suit/hazardvest{
	desc = "A high-visibility lifejacket complete with whistle and slot for oxygen tanks.";
	name = "emergency lifejacket"
	},
/obj/item/clothing/suit/hazardvest{
	desc = "A high-visibility lifejacket complete with whistle and slot for oxygen tanks.";
	name = "emergency lifejacket"
	},
/obj/item/clothing/suit/hazardvest{
	desc = "A high-visibility lifejacket complete with whistle and slot for oxygen tanks.";
	name = "emergency lifejacket"
	},
/obj/item/tank/internals/emergency_oxygen/double{
	pixel_x = 3
	},
/obj/item/tank/internals/emergency_oxygen/double{
	pixel_x = 3
	},
/obj/item/tank/internals/emergency_oxygen/double{
	pixel_x = 3
	},
/obj/item/tank/internals/emergency_oxygen/double{
	pixel_x = 3
	},
/obj/item/tank/internals/emergency_oxygen/double{
	pixel_x = 3
	},
/obj/item/clothing/mask/breath{
	pixel_x = -3;
	pixel_y = -3
	},
/obj/item/clothing/mask/breath{
	pixel_x = -3;
	pixel_y = -3
	},
/obj/item/clothing/mask/breath{
	pixel_x = -3;
	pixel_y = -3
	},
/obj/item/clothing/mask/breath{
	pixel_x = -3;
	pixel_y = -3
	},
/obj/item/clothing/mask/breath{
	pixel_x = -3;
	pixel_y = -3
	},
/obj/item/clothing/head/hardhat/orange{
	name = "protective hat";
	pixel_y = 9
	},
/obj/item/clothing/head/hardhat/orange{
	name = "protective hat";
	pixel_y = 9
	},
/obj/item/clothing/head/hardhat/orange{
	name = "protective hat";
	pixel_y = 9
	},
/obj/item/clothing/head/hardhat/orange{
	name = "protective hat";
	pixel_y = 9
	},
/obj/item/clothing/head/hardhat/orange{
	name = "protective hat";
	pixel_y = 9
	},
/obj/structure/closet/crate/internals,
/obj/effect/turf_decal/bot,
/turf/open/floor/mineral/titanium,
/area/ruin/powered)
"JZ" = (
/turf/closed/mineral/titanium,
/area/ruin/powered)
"Kj" = (
/obj/machinery/power/floodlight,
/obj/structure/cable{
	icon_state = "0-2"
	},
/turf/open/floor/plating/asteroid,
/area/ruin/powered)
"Lt" = (
/obj/structure/mirror,
/turf/closed/wall/mineral/iron,
/area/ruin/powered)
"PG" = (
/turf/closed/mineral/gold,
/area/ruin/powered)
"Qi" = (
/obj/structure/cable,
/obj/machinery/power/port_gen/pacman{
	active = 1;
	anchored = 1;
	sheets = 10
	},
/turf/open/floor/plating/asteroid,
/area/ruin/powered)
"Sv" = (
/obj/effect/decal/cleanable/dirt,
/turf/open/floor/mineral/titanium,
/area/ruin/powered)
"Ue" = (
/turf/closed/mineral/diamond,
/area/ruin/powered)
"VS" = (
/turf/closed/mineral/uranium,
/area/ruin/powered)
"WH" = (
/obj/item/circuitboard/machine/mining_equipment_vendor/golem,
/obj/item/circuitboard/machine/ore_redemption,
/turf/open/floor/plating/asteroid,
/area/ruin/powered)
"WP" = (
/obj/item/stack/ore/gold,
/obj/item/stack/ore/gold,
/obj/item/stack/ore/gold,
/turf/open/floor/plating/asteroid,
/area/ruin/powered)
"Xh" = (
/obj/structure/cable{
	icon_state = "1-2"
	},
/turf/open/floor/plating/asteroid,
/area/ruin/powered)
"XQ" = (
/obj/structure/shuttle/engine/propulsion/left{
	dir = 4
	},
/turf/closed/wall/mineral/titanium,
/area/ruin/powered)

(1,1,1) = {"
aa
aa
aa
aa
aa
aa
aa
aa
aa
aa
aa
aa
aa
aa
aa
aa
aa
aa
aa
aa
aa
aa
aM
aa
aa
aa
aa
aa
aa
aa
aA
aO
aA
aA
aA
aA
aA
aa
aa
aa
aa
aa
aa
aa
aa
aa
aa
aa
aa
aa
"}
(2,1,1) = {"
aa
aa
aa
aa
aa
aa
aa
aa
aa
aa
aa
aa
aa
aa
aa
aa
aM
aa
aa
aa
aa
aa
aa
aa
aA
aA
aA
aA
aA
aA
aZ
aZ
aZ
aZ
aZ
aZ
aZ
aA
aA
aA
aa
aa
aa
aa
aM
aa
aa
aa
aa
aa
"}
(3,1,1) = {"
aa
aa
aa
aa
aa
aa
aa
aa
aa
aa
aa
aa
aa
aa
aa
aa
aa
aa
aa
aa
aa
aA
aA
aA
ab
aZ
aZ
aZ
aZ
aZ
bb
bb
bb
bb
bb
bb
bb
aZ
aZ
ab
aA
aA
aa
aa
aa
aa
aW
aa
aM
aa
"}
(4,1,1) = {"
aa
aa
aa
aa
aa
aa
aa
aa
aa
aa
aa
aa
aa
aa
aa
aa
aa
aa
aa
aa
aA
aZ
aZ
aZ
aZ
aZ
aZ
aZ
aZ
aZ
bb
bb
bb
bb
bb
bb
bb
aZ
aZ
aZ
aZ
aZ
aA
aa
aa
aV
aI
aX
aa
aa
"}
(5,1,1) = {"
aa
aa
aa
aa
aa
aa
aa
aa
aa
aa
aa
aa
aa
aa
aA
aA
aA
aA
aA
aA
aZ
aZ
aZ
aZ
aZ
aZ
aZ
aZ
aZ
fp
bb
bb
bb
bb
bb
bb
bb
aZ
aZ
aZ
aZ
aZ
aZ
aA
aa
aa
aa
aa
aa
aa
"}
(6,1,1) = {"
aa
aa
aa
aa
aa
aa
aa
aa
aa
aa
aa
aa
aa
aA
aZ
aZ
aZ
aZ
aA
aZ
aZ
aZ
fp
aZ
bb
aZ
bb
aZ
aZ
aZ
bb
bb
bb
bb
bb
bb
bb
bb
bb
aZ
aZ
aZ
aZ
aZ
aA
aa
aM
aa
aa
aa
"}
(7,1,1) = {"
aa
aa
aa
aa
aa
aa
aa
aa
aa
aa
aM
aa
aA
aZ
bb
bb
bb
bb
aZ
aZ
fp
aZ
aZ
aZ
aZ
aZ
bb
bb
bb
bb
bb
bb
bb
bb
bb
bb
bb
aZ
bb
bb
bb
bb
aZ
aZ
aZ
aA
aa
aa
aa
aa
"}
(8,1,1) = {"
aa
aa
aa
aa
aa
aa
ab
aa
aa
aa
aa
aa
aA
aZ
bb
bb
bb
bb
aZ
aZ
aZ
VS
aZ
aZ
aZ
aZ
bb
aZ
bb
bb
JZ
bb
bb
bb
bb
ae
af
ae
bb
bb
bb
bb
aZ
aZ
aZ
aZ
aA
aa
aa
aa
"}
(9,1,1) = {"
aa
aa
aa
aa
aA
ab
ab
aA
aa
aa
aa
aa
aA
aZ
bb
bb
bb
bb
fp
fp
fp
aZ
aZ
aZ
aZ
bb
bb
aZ
JZ
aZ
aZ
aZ
bb
bb
bb
af
aq
af
aZ
bb
bb
bb
bb
fp
aZ
aZ
aZ
aA
aa
aa
"}
(10,1,1) = {"
aa
aa
aa
aa
ab
ab
ab
ab
aA
aa
aa
aA
aA
aZ
bb
bb
bb
bb
fp
VS
fp
aZ
bb
fp
fp
bb
aZ
bb
bb
bb
bb
fp
bb
bb
ae
ae
ao
ae
ae
aZ
fp
bb
bb
bb
bb
bb
aZ
aA
aa
aa
"}
(11,1,1) = {"
aa
aa
aa
aA
ab
ab
ab
ab
aA
aa
aa
aA
aA
aZ
bb
bb
bb
bb
aZ
aZ
bb
aZ
Ue
aZ
bb
bb
bb
bb
bb
bb
aZ
aZ
bb
bb
af
an
an
an
af
aZ
fp
bb
bb
bb
fp
bb
aZ
aZ
aA
aa
"}
(12,1,1) = {"
aa
aa
aa
aA
ab
ab
ab
ab
aA
aa
aa
aA
aA
aA
aZ
bb
bb
bb
bb
bb
Ue
aZ
bb
aZ
aZ
bb
fp
bb
fp
fp
aZ
aZ
bb
ae
ae
bh
an
an
ae
ae
fp
fp
bb
jx
fp
bb
aZ
aZ
aA
aa
"}
(13,1,1) = {"
aa
aa
aa
aA
ab
ab
ab
ab
aA
aa
aa
aA
aA
aA
aZ
bb
bb
bb
bb
bb
bb
aZ
aZ
aZ
aZ
bb
aZ
bb
aZ
aZ
aZ
aZ
bb
af
aY
ao
ao
ao
ak
af
aZ
bb
fp
bb
bb
bb
aZ
aZ
aA
aa
"}
(14,1,1) = {"
aa
aa
aa
aa
ab
ab
ab
ab
aA
aa
aa
aA
aA
aA
aZ
bb
bb
bb
bb
bb
fp
bb
aZ
fp
aZ
bb
bb
bb
aZ
aZ
aZ
bb
bb
al
aj
ap
an
as
aj
al
aZ
bb
jx
bb
bb
fp
aZ
aZ
aA
aa
"}
(15,1,1) = {"
aa
aa
aa
aa
aA
ab
ab
aA
aa
aa
aa
aA
aA
aA
aZ
bb
fp
bb
bb
bb
bb
bb
aZ
aZ
aZ
fp
fp
fp
bb
bb
bb
bb
bb
af
ak
DH
an
mr
ak
af
am
bb
bb
bb
bb
bb
aZ
aZ
aA
aa
"}
(16,1,1) = {"
aa
aa
aa
aa
aa
aa
ab
aa
aa
aa
aa
aA
aA
ab
aZ
bb
bb
bb
bb
bb
bb
bb
ah
az
aZ
aZ
aZ
aZ
aZ
aZ
aZ
bb
aR
ae
ae
af
bl
af
ae
ae
am
bb
bb
bb
bb
bb
bb
aZ
aA
aM
"}
(17,1,1) = {"
aa
aa
aa
aa
aa
aa
aa
aa
aa
aa
aa
aA
aA
ab
aZ
bb
bb
bb
bb
bb
bb
aZ
am
am
aZ
aZ
aZ
aZ
aZ
aZ
aZ
bb
aR
ae
ag
nl
an
HP
at
ae
am
bb
fp
bb
bb
bb
bb
aZ
aA
aa
"}
(18,1,1) = {"
aa
aa
aa
aa
aa
aa
aa
aa
aa
aa
aa
aA
aA
ab
aZ
bb
bb
bb
bb
bb
bb
ad
am
am
am
am
aZ
aH
aJ
aL
bb
bb
aT
bl
br
an
an
an
an
bl
aR
bb
bb
bb
bb
bb
bb
aZ
aA
aa
"}
(19,1,1) = {"
aa
aa
aa
aa
aa
aa
aa
aa
aa
aa
aA
aE
aZ
aZ
aZ
bb
bb
bb
bb
bb
bb
ad
au
am
aB
am
am
am
am
am
aZ
bb
am
af
Ft
zs
Sv
CY
wU
af
bg
bb
fp
jx
bb
bb
bb
aZ
aA
aa
"}
(20,1,1) = {"
aa
aa
aa
aa
aa
aa
aa
aa
aa
aa
aA
aE
aZ
aZ
aZ
bb
bb
bb
bb
bb
bb
ad
aw
bs
aC
bC
WH
am
am
am
aZ
bb
bb
ae
Iy
aF
br
CY
CY
ae
bb
bb
bb
bb
bb
bb
bb
aZ
aA
aa
"}
(21,1,1) = {"
aa
aa
aa
aa
aa
aa
aa
aM
aa
aa
aA
aE
aZ
aZ
bb
bb
bb
bb
bb
bb
bb
ad
ax
am
aD
am
am
am
am
bb
bb
bb
am
bd
bd
af
bl
af
XQ
XQ
bb
bb
bb
bb
bb
bb
bb
aZ
aA
aa
"}
(22,1,1) = {"
aa
aa
aa
aa
aa
aa
aa
aa
aa
aa
aA
aE
aZ
aZ
bb
fp
bb
fp
bb
bb
bb
ad
ay
am
am
am
aG
am
am
bb
bb
aZ
am
am
am
am
am
am
am
am
am
bb
bb
bb
fp
aZ
aZ
aZ
aA
aa
"}
(23,1,1) = {"
aa
aa
aa
aa
aa
aa
aa
aa
aa
aa
aA
aZ
aZ
aZ
aZ
bb
bb
bb
bb
bb
bb
ar
ar
ar
ar
am
am
am
am
bb
bb
bb
am
am
am
am
am
am
am
am
am
bb
bb
bb
bb
aZ
aZ
aE
aa
aa
"}
(24,1,1) = {"
aa
aa
aa
aa
aa
aa
aa
aa
aa
aA
aE
aZ
aZ
aZ
aZ
bb
bb
bb
bb
bb
bb
ar
av
am
ar
am
am
am
am
am
bb
bb
am
am
am
am
am
am
am
am
am
bb
bb
bb
fp
aZ
aZ
aA
aa
aa
"}
(25,1,1) = {"
aa
aa
aa
aa
aa
aa
aa
aa
aa
aA
aZ
aZ
aZ
aZ
aZ
bb
bb
bb
fp
bb
bb
ar
aU
be
bf
am
am
am
am
am
aN
am
am
am
am
aR
am
Kj
HK
am
bb
bb
fp
bb
bb
aZ
aA
aa
aa
aa
"}
(26,1,1) = {"
aa
aa
aa
aa
aa
aa
aa
aa
aa
aA
aZ
aZ
aZ
aZ
bb
nc
bb
bb
bb
bb
bb
ar
bc
am
ar
am
am
am
am
aZ
aZ
am
am
am
am
am
am
am
oR
Xh
Xh
Qi
aZ
aZ
aZ
aZ
aa
aa
aa
aa
"}
(27,1,1) = {"
aa
aa
aa
aa
aa
aa
aa
aa
aa
aA
aZ
aZ
aZ
aZ
aZ
bb
bb
bb
bb
bb
bb
ar
ar
ar
ar
aZ
aZ
aZ
aK
aZ
aZ
bm
bo
am
am
am
am
am
am
am
fc
aR
aZ
aZ
aZ
aE
aa
aa
aa
aM
"}
(28,1,1) = {"
aa
aa
aa
aa
aa
aa
aa
aa
aa
aa
aE
aZ
aZ
aZ
nc
bb
bb
fp
fp
bb
bb
fp
bb
bb
bb
bb
bb
fp
aZ
fp
aZ
bn
bp
am
am
am
am
am
aP
am
am
aR
aZ
aZ
aZ
aA
aa
aa
aa
aa
"}
(29,1,1) = {"
aa
aa
aa
aa
aa
aa
aa
aa
aa
aa
aE
aZ
aZ
aZ
aZ
bb
bb
bb
fp
bb
fp
bb
bb
bb
bb
bb
bb
bb
aZ
aZ
aZ
aQ
bq
am
am
aR
am
am
WP
aP
bb
am
aZ
aZ
aZ
aA
aa
aa
aa
aa
"}
(30,1,1) = {"
aa
aa
aa
aa
aa
aa
aa
aa
aa
aa
aE
aZ
aZ
aZ
aZ
bb
bb
bb
bb
bb
bb
bb
bb
bb
bb
PG
bb
bb
aZ
aZ
aZ
aZ
aZ
am
am
am
am
aP
am
bg
bb
bb
bb
aZ
aZ
aa
aa
aa
aa
aa
"}
(31,1,1) = {"
aa
aa
aa
aa
aa
aa
aa
aa
aa
aa
aE
aZ
aZ
aZ
aZ
bb
bb
bb
fp
bb
bb
bb
fp
bb
PG
fp
bb
bb
bb
bb
bb
aZ
aZ
am
am
am
am
am
am
aS
bb
fp
bb
aZ
aE
aa
aa
aa
ab
aA
"}
(32,1,1) = {"
aa
aa
aa
aa
aa
aa
aa
aa
aa
aa
aa
aA
aA
aZ
aZ
bb
bb
bb
fp
fp
bb
bb
bb
bb
bb
bb
bb
bb
bb
bb
bb
bb
aZ
bg
am
am
am
ma
am
aS
bb
fp
bb
aZ
aE
aa
aa
aO
ab
ab
"}
(33,1,1) = {"
aa
aa
aa
aa
aa
aa
aa
aa
aa
aa
aa
aa
aA
aZ
aZ
bb
bb
bb
bb
bb
bb
bb
bb
bb
bb
bb
bb
bb
aZ
bb
bb
fp
aZ
am
am
bj
am
am
am
aS
fp
bb
bb
aZ
aE
aa
aA
ab
ab
ab
"}
(34,1,1) = {"
aa
aa
aa
aa
aa
aa
aa
aa
aa
aa
aa
aa
aa
aE
aZ
aZ
aZ
aZ
aZ
aZ
bb
bb
bb
bb
bb
bb
bb
bb
aZ
aZ
aZ
aZ
aZ
aS
bi
am
am
am
aS
aS
bb
bb
bb
aZ
aE
aa
aA
ab
ab
aA
"}
(35,1,1) = {"
aa
aa
aa
aa
aa
aa
aA
aA
aa
aa
aa
aa
aM
aa
aE
aZ
aZ
aZ
aZ
aZ
bb
bb
bb
bb
bb
bb
bb
fp
aZ
aZ
aZ
aZ
aZ
aS
am
am
am
am
aS
aS
aZ
aZ
aZ
aE
aa
aa
aA
ab
ab
ab
"}
(36,1,1) = {"
aa
aa
aa
aa
aa
aa
ab
ab
aA
aa
aa
aa
aa
aa
aE
aZ
aZ
aZ
aZ
aZ
bb
bb
bb
fp
bb
bb
bb
bb
aZ
aZ
aZ
aE
aS
aS
Lt
bk
bk
aS
aS
aS
aS
aZ
aZ
aE
aa
aa
aa
ab
ab
ab
"}
(37,1,1) = {"
aa
aa
aa
aa
aa
ab
ab
ab
ab
aa
aa
aa
aa
aa
aE
aE
aZ
aZ
aZ
aZ
bb
bb
bb
bb
bb
bb
fp
fp
aZ
aZ
aE
aE
aE
aS
aS
aS
bk
aS
aS
aS
aE
aE
aZ
aE
aa
aa
aa
aa
aA
aA
"}
(38,1,1) = {"
aa
aa
aa
aa
aa
ab
ab
ab
ab
ab
aa
aa
aa
aa
aa
aE
aE
aZ
aZ
aZ
bb
bb
bb
bb
bb
bb
bb
aZ
aZ
aZ
aE
aE
ai
ai
ai
ai
ai
ai
ai
ai
aA
aA
ab
aA
aa
aa
aa
aa
aa
aa
"}
(39,1,1) = {"
aa
aa
aa
aa
aa
aA
ab
ab
ab
ab
aa
aa
aa
aa
aa
aa
aE
aE
aZ
aZ
fp
fp
bb
bb
bb
bb
bb
aZ
aZ
aZ
aE
aa
aa
aa
ai
ai
ai
aa
ai
aa
aa
aA
ab
aA
aa
aa
aa
aa
aa
aa
"}
(40,1,1) = {"
aa
aa
aa
aa
aa
aa
aA
ab
ab
aA
aa
aa
aa
aa
aa
aa
aa
aE
aE
aZ
aZ
aZ
aZ
aZ
aZ
bb
bb
aZ
aZ
aZ
aZ
aZ
aa
aa
aa
aa
aa
aa
ai
aa
aa
ab
ab
aA
aa
aa
aa
aa
aa
aa
"}
(41,1,1) = {"
aa
aa
aa
aa
aa
aa
aa
aa
aa
aa
aa
aa
aa
aa
aa
aa
aa
aa
aE
aE
aZ
aZ
aZ
aZ
aZ
aZ
aZ
aZ
aZ
aZ
aZ
aZ
aa
aa
aa
aa
aa
aa
aa
aa
aa
ab
ab
aA
aa
aa
aa
aa
aa
aa
"}
(42,1,1) = {"
aa
aa
aa
aa
aa
aa
aa
aa
aa
aa
aa
aa
aa
aa
aa
aa
aa
aa
aa
aA
aA
aA
aA
aA
aA
aA
aA
aA
ab
ab
ab
ab
ab
aa
aa
aa
aa
aa
aa
aa
aa
ab
aa
aa
aa
aa
aM
aa
aa
aa
"}
(43,1,1) = {"
aa
aa
aa
aa
aa
aa
aa
aa
aa
aa
aa
aa
aa
aa
aa
aa
aa
aa
aa
aa
aa
aa
aa
aa
aa
aa
aa
aA
aA
aA
aA
aA
ab
aa
aa
aa
aa
aa
aa
aa
aa
aa
aa
aa
aa
aa
aa
aa
aa
aa
"}
(44,1,1) = {"
aa
aa
aa
aa
aa
aa
aa
aa
aa
aa
aa
aa
aa
aa
aa
aa
aa
aa
aa
aa
aa
aa
aa
aa
aa
aa
aa
aa
aa
aa
aa
aa
aa
aa
aa
aa
aa
aa
aa
aa
aa
aa
aa
aa
aa
aa
aA
aa
aa
aa
"}
(45,1,1) = {"
aa
aa
aa
aa
aa
aa
aa
aa
aa
aa
aa
aa
aa
aa
aA
aa
aa
aa
aa
aM
aa
aa
aa
aa
aa
aa
aa
aM
aa
aa
aa
aa
aa
aa
aa
aa
aa
aa
aa
aa
aM
aa
aa
aa
aa
aA
ab
aA
aa
aa
"}
(46,1,1) = {"
aa
aa
aa
aa
aa
aa
aa
aa
aa
aa
aa
aa
aa
aM
ab
ab
aA
aa
aa
aa
aa
aa
aa
aa
aa
aa
aa
aa
aa
aa
aa
aa
aa
aa
aa
aa
aa
aa
aa
aa
aa
aa
aa
aa
aa
ab
ab
ab
aa
aa
"}
(47,1,1) = {"
aa
aa
aa
aa
aa
aa
aa
aa
aa
aa
aa
aa
aa
ab
ab
ab
ab
aA
aa
aa
aa
aa
aa
aa
aa
aa
aa
aa
aa
aa
aa
aa
aA
aA
aa
aa
aa
aa
aa
aa
aa
aa
aa
aa
aa
ab
ab
ab
aa
aa
"}
(48,1,1) = {"
aa
aa
aa
aa
aa
aa
aa
aa
aa
aa
aa
aa
aa
aA
ab
ab
ab
ab
aa
aa
aa
aM
aa
aa
aa
aa
aa
aa
aa
aa
aa
aA
ab
aA
aa
aa
aa
aa
aa
aa
aa
aa
aa
aa
aa
aA
ab
aA
aa
aa
"}
(49,1,1) = {"
aa
aa
aa
aa
aa
aa
aa
aa
aa
aa
aa
aa
aa
aa
aa
aA
aA
aa
aa
aa
aa
aa
aa
aa
aa
aa
aa
aa
aa
aa
aa
aa
aA
aa
aa
aa
aa
aM
aa
aa
aa
aa
aa
aa
aa
aA
aa
aa
aa
aa
"}
(50,1,1) = {"
aa
aa
aa
aa
aa
aa
aa
aa
aa
aa
aa
aa
aa
aa
aa
aa
aa
aa
aa
aa
aa
aa
aa
aa
aa
aa
aa
aa
aa
aa
aa
aa
aa
aa
aa
aa
aa
aa
aa
aa
aa
aa
aa
aa
aa
ab
aa
aa
aa
aa
"}
