//MAP CONVERTED BY dmm2tgm.py THIS HEADER COMMENT PREVENTS RECONVERSION, DO NOT REMOVE
"aa" = (
/turf/template_noop,
/area/template_noop)
"ab" = (
/turf/closed/mineral/random/low_chance,
/area/ruin/unpowered)
"ac" = (
/turf/open/floor/plating/asteroid,
/area/ruin/unpowered)
"ad" = (
/obj/machinery/hydroponics/soil,
/turf/open/floor/plating/asteroid,
/area/ruin/powered)
"ae" = (
/turf/closed/wall/mineral/titanium,
/area/ruin/powered)
"af" = (
/obj/effect/spawner/structure/window/shuttle,
/turf/open/floor/mineral/titanium,
/area/ruin/powered)
"ag" = (
/obj/structure/shuttle/engine/propulsion/right{
	dir = 4
	},
/turf/closed/wall/mineral/titanium,
/area/ruin/powered)
"ah" = (
/obj/structure/table/wood,
/obj/item/shovel,
/turf/open/floor/plating/asteroid,
/area/ruin/powered)
"ai" = (
/obj/structure/lattice,
/turf/template_noop,
/area/template_noop)
"aj" = (
/obj/machinery/computer/cryopod,
/turf/closed/wall/mineral/titanium,
/area/ruin/powered)
"ak" = (
/obj/structure/fluff/empty_cryostasis_sleeper,
/turf/open/floor/mineral/titanium,
/area/ruin/powered)
"al" = (
/obj/machinery/status_display/shuttle,
/turf/closed/wall/mineral/titanium,
/area/ruin/powered)
"am" = (
/turf/open/floor/plating/asteroid,
/area/ruin/powered)
"an" = (
/turf/open/floor/mineral/titanium,
/area/ruin/powered)
"ao" = (
/obj/structure/chair/comfy/shuttle{
	dir = 8
	},
/turf/open/floor/mineral/titanium,
/area/ruin/powered)
"ap" = (
/obj/machinery/light{
	dir = 1
	},
/turf/open/floor/mineral/titanium,
/area/ruin/powered)
"aq" = (
/obj/machinery/computer{
	desc = "A computer long since rendered non-functional due to lack of maintenance. Spitting out error messages.";
	dir = 4;
	name = "Broken Computer"
	},
/turf/open/floor/mineral/titanium,
/area/ruin/powered)
"ar" = (
/obj/machinery/door/airlock/titanium{
	name = "Escape Pod Airlock"
	},
/turf/open/floor/mineral/titanium,
/area/ruin/powered)
"as" = (
/obj/machinery/light,
/turf/open/floor/mineral/titanium,
/area/ruin/powered)
"at" = (
/obj/structure/shuttle/engine/propulsion/left{
	dir = 4
	},
/turf/closed/wall/mineral/titanium,
/area/ruin/powered)
"au" = (
/obj/item/seeds/tower,
/obj/item/seeds/tower,
/obj/item/seeds/tower,
/turf/open/floor/plating/asteroid,
/area/ruin/powered)
"av" = (
/obj/structure/table/wood,
/obj/item/paper/crumpled{
	info = "</b><br><br>So this is it, I guess.. Always thought I'd go out doing something stupid, but.. not like this.<br>Should anyone find this note, tell Jeremy Clarke he can kiss my ass. Launching the pod unprepared like that..<br>Well. Now that I'm keeling over here, I guess I should write how I came to be the last one standing here.<br>Four of us took this pod.. only three of us woke up though.. fourth pod is locked from the inside, we couldn't figure out how to get it open.<br>Me and the clown set up a farm s'we can survive at least a while.. though, he didn't seem to understand that man cannot live on banana alone.<br>Had a bunch of circuits on him for some reason when he eventually passed, whispered to me something about a chem dispenser.. I.. don't know what he meant by that. I was never good with machinary. Maybe he wanted space lube?<br>The assistant that we gave the space suit to go out and find help never came back.. I'm betting he found salvation and left us behind.. never can trust those grubby greytiders."
	},
/obj/item/pen,
/obj/item/stock_parts/cell/hyper,
/turf/open/floor/plating/asteroid,
/area/ruin/powered)
"aw" = (
/obj/item/stack/sheet/mineral/wood,
/obj/item/stack/sheet/mineral/wood,
/obj/item/stack/sheet/mineral/wood,
/obj/item/stack/sheet/mineral/wood,
/obj/item/stack/sheet/mineral/wood,
/turf/open/floor/plating/asteroid,
/area/ruin/powered)
"ax" = (
/obj/item/twohanded/spear,
/turf/open/floor/plating/asteroid,
/area/ruin/powered)
"ay" = (
/obj/item/grown/log,
/obj/item/grown/log,
/turf/open/floor/plating/asteroid,
/area/ruin/powered)
"az" = (
/obj/structure/table/wood,
/obj/item/storage/bag/plants/portaseeder,
/turf/open/floor/plating/asteroid,
/area/ruin/powered)
"aA" = (
/turf/open/floor/plating/asteroid/airless,
/area/ruin/unpowered)
"aB" = (
/obj/item/seeds/banana,
/obj/item/seeds/banana,
/turf/open/floor/plating/asteroid,
/area/ruin/powered)
"aC" = (
/obj/effect/mob_spawn/human/clown/corpse,
/obj/structure/fans/tiny/invisible,
/turf/open/floor/plating/asteroid,
/area/ruin/powered)
"aD" = (
/obj/item/mining_scanner,
/turf/open/floor/plating/asteroid,
/area/ruin/powered)
"aE" = (
/turf/open/floor/plating/asteroid/airless,
/area/ruin/powered)
"aF" = (
/turf/open/floor/plating/asteroid,
/area/ruin/powered)
"aG" = (
/obj/structure/sink/puddle,
/turf/open/floor/plating/asteroid,
/area/ruin/powered)
"aH" = (
/obj/structure/table/wood,
/obj/item/storage/firstaid/regular,
/turf/open/floor/plating/asteroid,
/area/ruin/powered)
"aI" = (
/obj/effect/mob_spawn/human/corpse/assistant,
/turf/template_noop,
/area/template_noop)
"aJ" = (
/obj/structure/table/wood,
/obj/item/storage/bag/ore,
/turf/open/floor/plating/asteroid,
/area/ruin/powered)
"aK" = (
/obj/structure/reagent_dispensers/fueltank,
/turf/open/floor/plating/asteroid,
/area/ruin/powered)
"aL" = (
/obj/structure/table/wood,
/obj/item/storage/toolbox/mechanical,
/obj/item/clothing/head/welding,
/turf/open/floor/plating/asteroid,
/area/ruin/powered)
"aM" = (
/mob/living/simple_animal/hostile/carp,
/turf/template_noop,
/area/template_noop)
"aN" = (
/obj/structure/mineral_door/sandstone,
/turf/open/floor/plating/asteroid,
/area/ruin/powered)
"aO" = (
/mob/living/simple_animal/hostile/carp,
/turf/open/floor/plating/asteroid/airless,
/area/ruin/unpowered)
"aP" = (
/obj/item/stack/ore/gold,
/turf/open/floor/plating/asteroid,
/area/ruin/powered)
"aQ" = (
/obj/item/stack/ore/gold,
/obj/item/stack/ore/gold,
/obj/item/stack/ore/gold,
/turf/open/floor/plating/asteroid,
/area/ruin/powered)
"aR" = (
/obj/item/stack/ore/iron,
/turf/open/floor/plating/asteroid,
/area/ruin/powered)
"aS" = (
/turf/closed/wall/mineral/iron,
/area/ruin/powered)
"aT" = (
/obj/item/stack/ore/iron,
/obj/item/stack/ore/iron,
/turf/open/floor/plating/asteroid,
/area/ruin/powered)
"aU" = (
/obj/item/flashlight/lamp,
/obj/structure/table/wood,
/turf/open/floor/plating/asteroid,
/area/ruin/powered)
"aV" = (
/obj/item/clothing/suit/space/orange,
/turf/template_noop,
/area/template_noop)
"aW" = (
/obj/item/clothing/head/helmet/space/orange,
/turf/template_noop,
/area/template_noop)
"aX" = (
/mob/living/simple_animal/hostile/carp/megacarp,
/turf/template_noop,
/area/template_noop)
"aY" = (
/obj/effect/mob_spawn/human/hermit{
	flavour_text = "<span class='big bold'>You've been late to awaken from your cryo slumber. Blasted machine, you set it to 10 days not 10 weeks!</span><b> Where have the others gone while we were out? Did they manage to survive? These thoughts are dispelled by yet another recollection of how you got here... ";
	job_description = "Space Hermit"
	},
/turf/open/floor/mineral/titanium,
/area/ruin/powered)
"aZ" = (
/turf/closed/mineral/random/low_chance,
/area/ruin/powered)
"ba" = (
/turf/closed/mineral/random/low_chance/earth_like,
/area/ruin/powered)
"bb" = (
/turf/closed/mineral/random/earth_like,
/area/ruin/powered)
"bc" = (
/obj/item/circuitboard/machine/circuit_imprinter,
/turf/open/floor/plating/asteroid,
/area/ruin/powered)
"bd" = (
/obj/item/grown/bananapeel,
/turf/open/floor/plating/asteroid,
/area/ruin/powered)
"be" = (
/obj/effect/mob_spawn/human/corpse/cargo_tech,
/obj/structure/fans/tiny/invisible,
/turf/open/floor/plating/asteroid,
/area/ruin/powered)
"bf" = (
/obj/item/clothing/glasses/meson,
/turf/open/floor/plating/asteroid,
/area/ruin/powered)
"bg" = (
/obj/item/stock_parts/matter_bin/adv,
/turf/open/floor/plating/asteroid,
/area/ruin/powered)
"bh" = (
/obj/item/circuitboard/machine/autolathe,
/turf/open/floor/mineral/titanium,
/area/ruin/powered)
"bi" = (
/obj/item/stock_parts/manipulator/pico,
/turf/open/floor/plating/asteroid,
/area/ruin/powered)
"bj" = (
/obj/item/holosign_creator/atmos,
/turf/open/floor/plating/asteroid,
/area/ruin/powered)
"bk" = (
/obj/structure/holosign/barrier/atmos,
/turf/open/floor/plating/asteroid,
/area/ruin/powered)
"bl" = (
/obj/machinery/power/floodlight,
/obj/structure/cable{
	icon_state = "0-2"
	},
/turf/open/floor/plating/asteroid,
/area/ruin/powered)
"bm" = (
/obj/structure/cable{
	icon_state = "1-4"
	},
/turf/open/floor/plating/asteroid,
/area/ruin/powered)
"bn" = (
/obj/structure/cable{
	icon_state = "2-8"
	},
/turf/open/floor/plating/asteroid,
/area/ruin/powered)
"bo" = (
/obj/structure/cable{
	icon_state = "1-2"
	},
/turf/open/floor/plating/asteroid,
/area/ruin/powered)
"bp" = (
/obj/item/stack/ore/iron,
/obj/item/stack/ore/iron,
/obj/item/stack/ore/iron,
/turf/open/floor/plating/asteroid,
/area/ruin/powered)
"bq" = (
/obj/structure/cable,
/obj/machinery/power/port_gen/pacman{
	active = 1;
	anchored = 1;
	sheets = 10
	},
/turf/open/floor/plating/asteroid,
/area/ruin/powered)
"br" = (
/obj/item/stack/ore/iron,
/obj/item/stack/sheet/mineral/plasma,
/obj/item/stack/sheet/mineral/plasma,
/turf/open/floor/plating/asteroid,
/area/ruin/powered)
"bs" = (
/obj/item/flashlight/lamp/bananalamp,
/turf/open/floor/plating/asteroid,
/area/ruin/powered)
"bt" = (
/turf/closed/mineral/random/low_chance/earth_like,
/area/ruin/unpowered)
"bC" = (
/obj/item/pickaxe/titanium,
/turf/open/floor/plating/asteroid,
/area/ruin/powered)
"fp" = (
/turf/closed/mineral/random/high_chance/earth_like,
/area/ruin/powered)
"jx" = (
/turf/closed/mineral/silver/earth_like,
/area/ruin/powered)
"nc" = (
/turf/closed/mineral/bscrystal/earth_like,
/area/ruin/powered)
"JZ" = (
/turf/closed/mineral/titanium/earth_like,
/area/ruin/powered)
"Lt" = (
/obj/structure/mirror,
/turf/closed/wall/mineral/iron,
/area/ruin/powered)
"PG" = (
/turf/closed/mineral/gold/earth_like,
/area/ruin/powered)
"Ue" = (
/turf/closed/mineral/diamond/earth_like,
/area/ruin/powered)
"VS" = (
/turf/closed/mineral/uranium/earth_like,
/area/ruin/powered)
"WH" = (
/obj/item/circuitboard/machine/mining_equipment_vendor/golem,
/obj/item/circuitboard/machine/ore_redemption,
/turf/open/floor/plating/asteroid,
/area/ruin/powered)

(1,1,1) = {"
aa
aa
aa
aa
aa
aa
aa
aa
aa
aa
aa
aa
aa
aa
aa
aa
aa
aa
aa
aa
aa
aa
aM
aa
aa
aa
aa
aa
aa
aa
ac
aO
aA
aA
aA
aA
aA
aa
aa
aa
aa
aa
aa
aa
aa
aa
aa
aa
aa
aa
"}
(2,1,1) = {"
aa
aa
aa
aa
aa
aa
aa
aa
aa
aa
aa
aa
aa
aa
aa
aa
aM
aa
aa
aa
aa
aa
aa
aa
aA
aA
aA
aA
aA
aA
aZ
aZ
aZ
aZ
aZ
aZ
aZ
aA
aA
aA
aa
aa
aa
aa
aM
aa
aa
aa
aa
aa
"}
(3,1,1) = {"
aa
aa
aa
aa
aa
aa
aa
aa
aa
aa
aa
aa
aa
aa
aa
aa
aa
aa
aa
aa
aa
aA
aA
aA
ab
aZ
aZ
aZ
aZ
aZ
bb
bb
bb
bb
bb
bb
bb
aZ
aZ
ab
aA
aA
aa
aa
aa
aa
aW
aa
aM
aa
"}
(4,1,1) = {"
aa
aa
aa
aa
aa
aa
aa
aa
aa
aa
aa
aa
aa
aa
aa
aa
aa
aa
aa
aa
aA
aZ
aZ
aZ
ba
ba
ba
ba
ba
ba
bb
bb
bb
bb
bb
bb
bb
ba
ba
ba
aZ
aZ
aA
aa
aa
aV
aI
aX
aa
aa
"}
(5,1,1) = {"
aa
aa
aa
aa
aa
aa
aa
aa
aa
aa
aa
aa
aa
aa
aA
aA
aA
aA
aA
aA
aZ
ba
ba
ba
ba
ba
ba
ba
ba
fp
bb
bb
bb
bb
bb
bb
bb
ba
ba
ba
ba
ba
aZ
aA
aa
aa
aa
aa
aa
aa
"}
(6,1,1) = {"
aa
aa
aa
aa
aa
aa
aa
aa
aa
aa
aa
aa
aa
aA
aZ
aZ
aZ
aZ
aA
aZ
ba
ba
fp
ba
bb
ba
bb
ba
ba
ba
bb
bb
bb
bb
bb
bb
bb
bb
bb
ba
ba
ba
ba
aZ
aA
aa
aM
aa
aa
aa
"}
(7,1,1) = {"
aa
aa
aa
aa
aa
aa
aa
aa
aa
aa
aM
aa
aA
aZ
bb
bb
bb
bb
aZ
ba
fp
ba
ba
ba
ba
ba
bb
bb
bb
bb
bb
bb
bb
bb
bb
bb
bb
ba
bb
bb
bb
bb
ba
ba
aZ
aA
aa
aa
aa
aa
"}
(8,1,1) = {"
aa
aa
aa
aa
aa
aa
ab
aa
aa
aa
aa
aa
aA
aZ
bb
bb
bb
bb
ba
ba
ba
VS
ba
ba
ba
ba
bb
ba
bb
bb
JZ
bb
bb
bb
bb
ae
af
ae
bb
bb
bb
bb
ba
ba
ba
aZ
aA
aa
aa
aa
"}
(9,1,1) = {"
aa
aa
aa
aa
aA
ab
ab
aA
aa
aa
aa
aa
aA
aZ
bb
bb
bb
bb
fp
fp
fp
ba
ba
ba
ba
bb
bb
ba
JZ
ba
ba
ba
bb
bb
bb
af
aq
af
ba
bb
bb
bb
bb
fp
ba
ba
aZ
aA
aa
aa
"}
(10,1,1) = {"
aa
aa
aa
aa
ab
ab
ab
ab
aA
aa
aa
aA
aA
aZ
bb
bb
bb
bb
fp
VS
fp
ba
bb
fp
fp
bb
ba
bb
bb
bb
bb
fp
bb
bb
ae
ae
ao
ae
ae
ba
fp
bb
bb
bb
bb
bb
aZ
aA
aa
aa
"}
(11,1,1) = {"
aa
aa
aa
aA
ab
ab
ab
ab
aA
aa
aa
aA
aA
aZ
bb
bb
bb
bb
ba
ba
bb
ba
Ue
ba
bb
bb
bb
bb
bb
bb
ba
ba
bb
bb
af
an
an
an
af
ba
fp
bb
bb
bb
fp
bb
ba
aZ
aA
aa
"}
(12,1,1) = {"
aa
aa
aa
aA
ab
ab
ab
ab
aA
aa
aa
aA
aA
aA
aZ
bb
bb
bb
bb
bb
Ue
ba
bb
ba
ba
bb
fp
bb
fp
fp
ba
ba
bb
ae
ae
bh
an
an
ae
ae
fp
fp
bb
jx
fp
bb
ba
aZ
aA
aa
"}
(13,1,1) = {"
aa
aa
aa
aA
ab
ab
ab
ab
aA
aa
aa
aA
aA
aA
aZ
bb
bb
bb
bb
bb
bb
ba
ba
ba
ba
bb
ba
bb
ba
ba
ba
ba
bb
af
aY
ao
ao
ao
ak
af
ba
bb
fp
bb
bb
bb
ba
aZ
aA
aa
"}
(14,1,1) = {"
aa
aa
aa
aa
ab
ab
ab
ab
aA
aa
aa
aA
aA
aA
aZ
bb
bb
bb
bb
bb
fp
bb
ba
fp
ba
bb
bb
bb
ba
ba
ba
bb
bb
al
aj
ap
an
as
aj
al
ba
bb
jx
bb
bb
fp
ba
aZ
aA
aa
"}
(15,1,1) = {"
aa
aa
aa
aa
aA
ab
ab
aA
aa
aa
aa
aA
aA
aA
aZ
bb
fp
bb
bb
bb
bb
bb
ba
ba
ba
fp
fp
fp
bb
bb
bb
bb
bb
af
ak
ao
ao
ao
ak
af
aF
bb
bb
bb
bb
bb
ba
aZ
aA
aa
"}
(16,1,1) = {"
aa
aa
aa
aa
aa
aa
ab
aa
aa
aa
aa
aA
aA
ab
ba
bb
bb
bb
bb
bb
bb
bb
ah
az
ba
ba
ba
ba
ba
ba
ba
bb
aR
ae
ae
an
an
an
ae
ae
aF
bb
bb
bb
bb
bb
bb
aZ
aA
aM
"}
(17,1,1) = {"
aa
aa
aa
aa
aa
aa
aa
aa
aa
aa
aa
aA
aA
ab
ba
bb
bb
bb
bb
bb
bb
ba
aF
aF
ba
ba
ba
ba
ba
ba
ba
bb
aR
ag
ag
af
ar
af
at
at
aF
bb
fp
bb
bb
bb
bb
aZ
aA
aa
"}
(18,1,1) = {"
aa
aa
aa
aa
aa
aa
aa
aa
aa
aa
aa
aA
aA
ab
ba
bb
bb
bb
bb
bb
bb
ad
aF
aF
aF
aF
ba
aH
aJ
aL
bb
bb
aT
aF
aF
aF
aF
aF
aF
aF
aR
bb
bb
bb
bb
bb
bb
aZ
aA
aa
"}
(19,1,1) = {"
aa
aa
aa
aa
aa
aa
aa
aa
aa
aa
aA
aE
aZ
ba
ba
bb
bb
bb
bb
bb
bb
ad
au
aF
aB
aF
aF
aF
aF
aF
ba
bb
aF
aF
aF
aF
aF
aF
aF
aF
bg
bb
fp
jx
bb
bb
bb
aZ
aA
aa
"}
(20,1,1) = {"
aa
aa
aa
aa
aa
aa
aa
aa
aa
aa
aA
aE
aZ
ba
ba
bb
bb
bb
bb
bb
bb
ad
aw
bs
aC
bC
WH
aF
aF
aF
ba
bb
bb
aF
aF
aF
aF
aF
aF
aF
bb
bb
bb
bb
bb
bb
bb
aZ
aA
aa
"}
(21,1,1) = {"
aa
aa
aa
aa
aa
aa
aa
aM
aa
aa
aA
aE
aZ
ba
bb
bb
bb
bb
bb
bb
bb
ad
ax
aF
aD
aF
aF
aF
aF
bb
bb
bb
aU
bd
aF
aF
bl
bm
aF
aF
bb
bb
bb
bb
bb
bb
bb
aZ
aA
aa
"}
(22,1,1) = {"
aa
aa
aa
aa
aa
aa
aa
aa
aa
aa
aA
aE
aZ
ba
bb
fp
bb
fp
bb
bb
bb
ad
ay
aF
aF
aF
aG
aF
aF
bb
bb
ba
av
be
aF
aF
aF
bn
bo
bo
bq
bb
bb
bb
fp
ba
ba
aZ
aA
aa
"}
(23,1,1) = {"
aa
aa
aa
aa
aa
aa
aa
aa
aa
aa
aA
aZ
ba
ba
ba
bb
bb
bb
bb
bb
bb
ba
aF
aF
aF
aF
aF
aF
aF
bb
bb
bb
bc
bf
aF
aF
aF
aF
aF
aF
br
bb
bb
bb
bb
ba
aZ
aE
aa
aa
"}
(24,1,1) = {"
aa
aa
aa
aa
aa
aa
aa
aa
aa
aA
aE
aZ
ba
ba
ba
bb
bb
bb
bb
bb
bb
bb
bb
bb
bb
aF
aF
aF
aF
aF
bb
bb
aF
aF
aF
aF
aF
aF
aF
aF
aF
bb
bb
bb
fp
ba
aZ
aA
aa
aa
"}
(25,1,1) = {"
aa
aa
aa
aa
aa
aa
aa
aa
aa
aA
aZ
ba
ba
ba
ba
bb
bb
bb
fp
bb
bb
bb
bb
bb
bb
aF
aF
aF
aF
aF
aN
aF
aF
aF
aF
aR
aF
aF
aF
aF
bb
bb
fp
bb
bb
aZ
aA
aa
aa
aa
"}
(26,1,1) = {"
aa
aa
aa
aa
aa
aa
aa
aa
aa
aA
aZ
ba
ba
ba
bb
nc
bb
bb
bb
bb
bb
bb
bb
bb
bb
ba
aF
aF
aF
ba
ba
aF
aF
aF
aF
aF
aF
aF
aF
aF
aF
aF
ba
ba
ba
aZ
aa
aa
aa
aa
"}
(27,1,1) = {"
aa
aa
aa
aa
aa
aa
aa
aa
aa
aA
aZ
ba
ba
ba
ba
bb
bb
bb
bb
bb
bb
bb
bb
bb
bb
ba
ba
ba
aK
ba
ba
aF
aF
aF
aF
aF
aF
aF
bp
aF
aF
aR
ba
ba
aZ
aE
aa
aa
aa
aM
"}
(28,1,1) = {"
aa
aa
aa
aa
aa
aa
aa
aa
aa
aa
aE
aZ
ba
ba
nc
bb
bb
fp
fp
bb
bb
fp
bb
bb
bb
bb
bb
fp
ba
fp
ba
aP
aF
aF
aF
aF
aF
aF
aF
aF
aF
aR
ba
ba
aZ
aA
aa
aa
aa
aa
"}
(29,1,1) = {"
aa
aa
aa
aa
aa
aa
aa
aa
aa
aa
aE
aZ
ba
ba
ba
bb
bb
bb
fp
bb
fp
bb
bb
bb
bb
bb
bb
bb
ba
ba
ba
aQ
aP
aF
aF
aR
aF
aF
aF
aF
bb
aF
ba
ba
aZ
aA
aa
aa
aa
aa
"}
(30,1,1) = {"
aa
aa
aa
aa
aa
aa
aa
aa
aa
aa
aE
aZ
ba
ba
ba
bb
bb
bb
bb
bb
bb
bb
bb
bb
bb
PG
bb
bb
ba
ba
ba
ba
ba
aF
aF
aF
aF
aP
aF
bg
bb
bb
bb
ba
aZ
aa
aa
aa
aa
aa
"}
(31,1,1) = {"
aa
aa
aa
aa
aa
aa
aa
aa
aa
aa
aE
aZ
aZ
ba
ba
bb
bb
bb
fp
bb
bb
bb
fp
bb
PG
fp
bb
bb
bb
bb
bb
ba
ba
aF
aF
aF
aF
aF
aF
aS
bb
fp
bb
aZ
aE
aa
aa
aa
ab
aA
"}
(32,1,1) = {"
aa
aa
aa
aa
aa
aa
aa
aa
aa
aa
aa
aA
aA
aZ
ba
bb
bb
bb
fp
fp
bb
bb
bb
bb
bb
bb
bb
bb
bb
bb
bb
bb
ba
bg
aF
aF
aF
aF
aF
aS
bb
fp
bb
aZ
aE
aa
aa
aO
ab
ab
"}
(33,1,1) = {"
aa
aa
aa
aa
aa
aa
aa
aa
aa
aa
aa
aa
aA
aZ
ba
bb
bb
bb
bb
bb
bb
bb
bb
bb
bb
bb
bb
bb
ba
bb
bb
fp
ba
aF
aF
bj
aF
aF
aF
aS
fp
bb
bb
aZ
aE
aa
aA
ab
ab
ab
"}
(34,1,1) = {"
aa
aa
aa
aa
aa
aa
aa
aa
aa
aa
aa
aa
aa
aE
aZ
ba
ba
ba
ba
ba
bb
bb
bb
bb
bb
bb
bb
bb
ba
ba
ba
ba
ba
aS
bi
aF
aF
aF
aS
aS
bb
bb
bb
aZ
aE
aa
aA
ab
ab
aA
"}
(35,1,1) = {"
aa
aa
aa
aa
aa
aa
aA
aA
aa
aa
aa
aa
aM
aa
aE
aZ
ba
ba
ba
ba
bb
bb
bb
bb
bb
bb
bb
fp
ba
ba
ba
aZ
ba
aS
aF
aF
aF
aF
aS
aS
ba
ba
aZ
aE
aa
aa
aA
ab
ab
ab
"}
(36,1,1) = {"
aa
aa
aa
aa
aa
aa
ab
ab
aA
aa
aa
aa
aa
aa
aE
aZ
ba
ba
ba
ba
bb
bb
bb
fp
bb
bb
bb
bb
ba
ba
aZ
aE
aS
aS
Lt
bk
bk
aS
aS
aS
aS
aZ
aZ
aE
aa
aa
aa
ab
ab
ab
"}
(37,1,1) = {"
aa
aa
aa
aa
aa
ab
ab
ab
ab
aa
aa
aa
aa
aa
aE
aE
aZ
ba
ba
ba
bb
bb
bb
bb
bb
bb
fp
fp
ba
aZ
aE
aE
aE
aS
aS
aS
bk
aS
aS
aS
aE
aE
aZ
aE
aa
aa
aa
aa
aA
aA
"}
(38,1,1) = {"
aa
aa
aa
aa
aa
ab
ab
ab
ab
ab
aa
aa
aa
aa
aa
aE
aE
aZ
ba
ba
bb
bb
bb
bb
bb
bb
bb
ba
ba
aZ
aE
aE
ai
ai
ai
ai
ai
ai
ai
ai
aA
aA
ab
aA
aa
aa
aa
aa
aa
aa
"}
(39,1,1) = {"
aa
aa
aa
aa
aa
aA
ab
ab
ab
ab
aa
aa
aa
aa
aa
aa
aE
aE
aZ
ba
fp
fp
bb
bb
bb
bb
bb
ba
ba
aZ
aE
aa
aa
aa
ai
ai
ai
aa
ai
aa
aa
aA
ab
aA
aa
aa
aa
aa
aa
aa
"}
(40,1,1) = {"
aa
aa
aa
aa
aa
aa
aA
ab
ab
aA
aa
aa
aa
aa
aa
aa
aa
aE
aE
aZ
ba
ba
ba
ba
ba
bb
bb
ba
ba
ba
aZ
aZ
aa
aa
aa
aa
aa
aa
ai
aa
aa
ab
ab
aA
aa
aa
aa
aa
aa
aa
"}
(41,1,1) = {"
aa
aa
aa
aa
aa
aa
aa
aa
aa
aa
aa
aa
aa
aa
aa
aa
aa
aa
aE
aE
aZ
aZ
aZ
aZ
aZ
aZ
aZ
aZ
ba
ba
ba
aZ
aa
aa
aa
aa
aa
aa
aa
aa
aa
ab
ab
aA
aa
aa
aa
aa
aa
aa
"}
(42,1,1) = {"
aa
aa
aa
aa
aa
aa
aa
aa
aa
aa
aa
aa
aa
aa
aa
aa
aa
aa
aa
aA
aA
aA
aA
aA
aA
aA
aA
aA
ab
ab
ab
ab
ab
aa
aa
aa
aa
aa
aa
aa
aa
ab
aa
aa
aa
aa
aM
aa
aa
aa
"}
(43,1,1) = {"
aa
aa
aa
aa
aa
aa
aa
aa
aa
aa
aa
aa
aa
aa
aa
aa
aa
aa
aa
aa
aa
aa
aa
aa
aa
aa
aa
aA
aA
aA
aA
aA
ab
aa
aa
aa
aa
aa
aa
aa
aa
aa
aa
aa
aa
aa
aa
aa
aa
aa
"}
(44,1,1) = {"
aa
aa
aa
aa
aa
aa
aa
aa
aa
aa
aa
aa
aa
aa
aa
aa
aa
aa
aa
aa
aa
aa
aa
aa
aa
aa
aa
aa
aa
aa
aa
aa
aa
aa
aa
aa
aa
aa
aa
aa
aa
aa
aa
aa
aa
aa
ac
aa
aa
aa
"}
(45,1,1) = {"
aa
aa
aa
aa
aa
aa
aa
aa
aa
aa
aa
aa
aa
aa
aA
aa
aa
aa
aa
aM
aa
aa
aa
aa
aa
aa
aa
aM
aa
aa
aa
aa
aa
aa
aa
aa
aa
aa
aa
aa
aM
aa
aa
aa
aa
ac
ab
ac
aa
aa
"}
(46,1,1) = {"
aa
aa
aa
aa
aa
aa
aa
aa
aa
aa
aa
aa
aa
aM
ab
ab
aA
aa
aa
aa
aa
aa
aa
aa
aa
aa
aa
aa
aa
aa
aa
aa
aa
aa
aa
aa
aa
aa
aa
aa
aa
aa
aa
aa
aa
ab
ab
ab
aa
aa
"}
(47,1,1) = {"
aa
aa
aa
aa
aa
aa
aa
aa
aa
aa
aa
aa
aa
ab
ab
ab
ab
aA
aa
aa
aa
aa
aa
aa
aa
aa
aa
aa
aa
aa
aa
aa
aA
aA
aa
aa
aa
aa
aa
aa
aa
aa
aa
aa
aa
ab
ab
ab
aa
aa
"}
(48,1,1) = {"
aa
aa
aa
aa
aa
aa
aa
aa
aa
aa
aa
aa
aa
aA
ab
ab
ab
ab
aa
aa
aa
aM
aa
aa
aa
aa
aa
aa
aa
aa
aa
aA
ab
aA
aa
aa
aa
aa
aa
aa
aa
aa
aa
aa
aa
ac
ab
ac
aa
aa
"}
(49,1,1) = {"
aa
aa
aa
aa
aa
aa
aa
aa
aa
aa
aa
aa
aa
aa
aa
aA
aA
aa
aa
aa
aa
aa
aa
aa
aa
aa
aa
aa
aa
aa
aa
aa
aA
aa
aa
aa
aa
aM
aa
aa
aa
aa
aa
aa
aa
ac
aa
aa
aa
aa
"}
(50,1,1) = {"
aa
aa
aa
aa
aa
aa
aa
aa
aa
aa
aa
aa
aa
aa
aa
aa
aa
aa
aa
aa
aa
aa
aa
aa
aa
aa
aa
aa
aa
aa
aa
aa
aa
aa
aa
aa
aa
aa
aa
aa
aa
aa
aa
aa
aa
bt
aa
aa
aa
aa
"}
