//MAP CONVERTED BY dmm2tgm.py THIS HEADER COMMENT PREVENTS RECONVERSION, DO NOT REMOVE
"aa" = (
/turf/template_noop,
/area/template_noop)
"ab" = (
/turf/closed/mineral/random/low_chance,
/area/ruin/space)
"ac" = (
/turf/open/floor/plating/asteroid,
/area/ruin/space)
"ad" = (
/obj/machinery/hydroponics/soil,
/turf/open/floor/plating/asteroid,
/area/ruin/space)
"ae" = (
/turf/closed/wall/mineral/titanium,
/area/ruin/space)
"af" = (
/obj/effect/spawner/structure/window/shuttle,
/turf/open/floor/mineral/titanium,
/area/ruin/space)
"ag" = (
/obj/structure/shuttle/engine/propulsion/right{
	dir = 4
	},
/turf/closed/wall/mineral/titanium,
/area/ruin/space)
"ah" = (
/obj/structure/table/wood,
/obj/item/shovel,
/turf/open/floor/plating/asteroid,
/area/ruin/space)
"ai" = (
/obj/structure/lattice,
/turf/template_noop,
/area/template_noop)
"aj" = (
/obj/machinery/computer/cryopod,
/turf/closed/wall/mineral/titanium,
/area/ruin/space)
"ak" = (
/obj/structure/fluff/empty_cryostasis_sleeper,
/turf/open/floor/mineral/titanium,
/area/ruin/space)
"al" = (
/obj/machinery/status_display/shuttle,
/turf/closed/wall/mineral/titanium,
/area/ruin/space)
"am" = (
/obj/item/circuitboard/computer/rdconsole,
/obj/item/circuitboard/machine/protolathe/department/science,
/turf/open/floor/plating/asteroid,
/area/ruin/space)
"an" = (
/turf/open/floor/mineral/titanium,
/area/ruin/space)
"ao" = (
/obj/structure/chair/comfy/shuttle{
	dir = 8
	},
/turf/open/floor/mineral/titanium,
/area/ruin/space)
"ap" = (
/obj/machinery/light{
	dir = 1
	},
/turf/open/floor/mineral/titanium,
/area/ruin/space)
"aq" = (
/obj/machinery/computer{
	desc = "A computer long since rendered non-functional due to lack of maintenance. Spitting out error messages.";
	dir = 4;
	name = "Broken Computer"
	},
/turf/open/floor/mineral/titanium,
/area/ruin/space)
"ar" = (
/obj/machinery/door/airlock/titanium{
	name = "Escape Pod Airlock"
	},
/turf/open/floor/mineral/titanium,
/area/ruin/space)
"as" = (
/obj/machinery/light,
/turf/open/floor/mineral/titanium,
/area/ruin/space)
"at" = (
/obj/structure/shuttle/engine/propulsion/left{
	dir = 4
	},
/turf/closed/wall/mineral/titanium,
/area/ruin/space)
"au" = (
/obj/item/seeds/tower,
/obj/item/seeds/tower,
/obj/item/seeds/tower,
/turf/open/floor/plating/asteroid,
/area/ruin/space)
"av" = (
/obj/structure/table/wood,
/obj/item/paper/crumpled{
	info = "</b><br><br>So this is it, I guess.. Always thought I'd go out doing something stupid, but.. not like this.<br>Should anyone find this note, tell Jeremy Clarke he can kiss my ass. Launching the pod unprepared like that..<br>Well. Now that I'm keeling over here, I guess I should write how I came to be the last one standing here.<br>Four of us took this pod.. only three of us woke up though.. fourth pod is locked from the inside, we couldn't figure out how to get it open.<br>Me and the clown set up a farm s'we can survive at least a while.. though, he didn't seem to understand that man cannot live on banana alone.<br>Had a bunch of circuits on him for some reason when he eventually passed, whispered to me something about a chem dispenser.. I.. don't know what he meant by that. I was never good with machinary. Maybe he wanted space lube?<br>The assistant that we gave the space suit to go out and find help never came back.. I'm betting he found salvation and left us behind.. never can trust those grubby greytiders."
	},
/obj/item/pen,
/turf/open/floor/plating/asteroid,
/area/ruin/space)
"aw" = (
/obj/item/stack/sheet/mineral/wood,
/obj/item/stack/sheet/mineral/wood,
/obj/item/stack/sheet/mineral/wood,
/obj/item/stack/sheet/mineral/wood,
/obj/item/stack/sheet/mineral/wood,
/turf/open/floor/plating/asteroid,
/area/ruin/space)
"ax" = (
/obj/item/twohanded/spear,
/turf/open/floor/plating/asteroid,
/area/ruin/space)
"ay" = (
/obj/item/grown/log,
/obj/item/grown/log,
/turf/open/floor/plating/asteroid,
/area/ruin/space)
"az" = (
/obj/structure/table/wood,
/obj/item/storage/bag/plants/portaseeder,
/turf/open/floor/plating/asteroid,
/area/ruin/space)
"aA" = (
/turf/open/floor/plating/asteroid/airless,
/area/ruin/space)
"aB" = (
/obj/item/seeds/banana,
/obj/item/seeds/banana,
/turf/open/floor/plating/asteroid,
/area/ruin/space)
"aC" = (
/obj/effect/mob_spawn/human/clown/corpse,
/obj/structure/fans/tiny/invisible,
/turf/open/floor/plating/asteroid,
/area/ruin/space)
"aD" = (
/obj/item/mining_scanner,
/turf/open/floor/plating/asteroid,
/area/ruin/space)
"aF" = (
/obj/item/pickaxe/emergency,
/turf/open/floor/plating/asteroid,
/area/ruin/space)
"aG" = (
/obj/structure/sink/puddle,
/turf/open/floor/plating/asteroid,
/area/ruin/space)
"aH" = (
/obj/structure/table/wood,
/obj/item/storage/firstaid/regular,
/turf/open/floor/plating/asteroid,
/area/ruin/space)
"aI" = (
/obj/effect/mob_spawn/human/corpse/assistant,
/turf/template_noop,
/area/template_noop)
"aJ" = (
/obj/structure/table/wood,
/obj/item/storage/bag/ore,
/turf/open/floor/plating/asteroid,
/area/ruin/space)
"aK" = (
/obj/structure/reagent_dispensers/fueltank,
/turf/open/floor/plating/asteroid,
/area/ruin/space)
"aL" = (
/obj/structure/table/wood,
/obj/item/storage/toolbox/mechanical,
/obj/item/clothing/head/welding,
/turf/open/floor/plating/asteroid,
/area/ruin/space)
"aM" = (
/mob/living/simple_animal/hostile/carp,
/turf/template_noop,
/area/template_noop)
"aN" = (
/obj/structure/mineral_door/sandstone,
/turf/open/floor/plating/asteroid,
/area/ruin/space)
"aO" = (
/mob/living/simple_animal/hostile/carp,
/turf/open/floor/plating/asteroid/airless,
/area/ruin/space)
"aP" = (
/obj/item/stack/ore/gold,
/turf/open/floor/plating/asteroid,
/area/ruin/space)
"aQ" = (
/obj/item/stack/ore/gold,
/obj/item/stack/ore/gold,
/obj/item/stack/ore/gold,
/turf/open/floor/plating/asteroid,
/area/ruin/space)
"aR" = (
/obj/item/stack/ore/iron,
/turf/open/floor/plating/asteroid,
/area/ruin/space)
"aS" = (
/turf/closed/wall/mineral/iron,
/area/ruin/space)
"aT" = (
/obj/item/stack/ore/iron,
/obj/item/stack/ore/iron,
/turf/open/floor/plating/asteroid,
/area/ruin/space)
"aU" = (
/obj/item/flashlight/lamp,
/obj/structure/table/wood,
/turf/open/floor/plating/asteroid,
/area/ruin/space)
"aV" = (
/obj/item/clothing/suit/space/orange,
/turf/template_noop,
/area/template_noop)
"aW" = (
/obj/item/clothing/head/helmet/space/orange,
/turf/template_noop,
/area/template_noop)
"aX" = (
/mob/living/simple_animal/hostile/carp/megacarp,
/turf/template_noop,
/area/template_noop)
"aY" = (
/obj/effect/mob_spawn/human/hermit{
	flavour_text = "<span class='big bold'>You've been late to awaken from your cryo slumber. Blasted machine, you set it to 10 days not 10 weeks!</span><b> Where have the others gone while we were out? Did they manage to survive? These thoughts are dispelled by yet another recollection of how you got here... ";
	job_description = "Space Hermit"
	},
/turf/open/floor/mineral/titanium,
/area/ruin/space)
"bc" = (
/obj/item/circuitboard/machine/circuit_imprinter,
/turf/open/floor/plating/asteroid,
/area/ruin/space)
"bd" = (
/obj/item/grown/bananapeel,
/turf/open/floor/plating/asteroid,
/area/ruin/space)
"be" = (
/obj/effect/mob_spawn/human/corpse/cargo_tech,
/obj/structure/fans/tiny/invisible,
/obj/effect/decal/cleanable/vomit,
/turf/open/floor/plating/asteroid,
/area/ruin/space)
"bf" = (
/obj/item/clothing/glasses/meson,
/turf/open/floor/plating/asteroid,
/area/ruin/space)
"bg" = (
/obj/item/stock_parts/matter_bin,
/turf/open/floor/plating/asteroid,
/area/ruin/space)
"bh" = (
/obj/item/circuitboard/machine/autolathe,
/turf/open/floor/mineral/titanium,
/area/ruin/space)
"bi" = (
/obj/item/stock_parts/manipulator,
/turf/open/floor/plating/asteroid,
/area/ruin/space)
"bj" = (
/obj/item/holosign_creator/atmos,
/turf/open/floor/plating/asteroid,
/area/ruin/space)
"bk" = (
/obj/structure/holosign/barrier/atmos,
/turf/open/floor/plating/asteroid,
/area/ruin/space)
"bl" = (
/obj/machinery/power/floodlight,
/obj/structure/cable{
	icon_state = "0-2"
	},
/turf/open/floor/plating/asteroid,
/area/ruin/space)
"bm" = (
/obj/structure/cable{
	icon_state = "1-4"
	},
/turf/open/floor/plating/asteroid,
/area/ruin/space)
"bn" = (
/obj/structure/cable{
	icon_state = "2-8"
	},
/turf/open/floor/plating/asteroid,
/area/ruin/space)
"bo" = (
/obj/structure/cable{
	icon_state = "1-2"
	},
/turf/open/floor/plating/asteroid,
/area/ruin/space)
"bp" = (
/obj/item/stack/ore/iron,
/obj/item/stack/ore/iron,
/obj/item/stack/ore/iron,
/turf/open/floor/plating/asteroid,
/area/ruin/space)
"bq" = (
/obj/structure/cable,
/obj/machinery/power/port_gen/pacman{
	active = 1;
	anchored = 1;
	sheets = 10
	},
/turf/open/floor/plating/asteroid,
/area/ruin/space)
"br" = (
/obj/item/stack/ore/iron,
/obj/item/stack/sheet/mineral/plasma,
/obj/item/stack/sheet/mineral/plasma,
/turf/open/floor/plating/asteroid,
/area/ruin/space)
"bs" = (
/obj/item/flashlight/lamp/bananalamp,
/turf/open/floor/plating/asteroid,
/area/ruin/space)
"bt" = (
/turf/closed/mineral/random/low_chance/earth_like,
/area/ruin/space)

(1,1,1) = {"
aa
aa
aa
aa
aa
aa
aa
aa
aa
aa
aa
aa
aa
aa
aa
aa
aa
aa
aa
aa
aa
aa
aM
aa
aa
aa
aa
aa
aa
aa
ac
aO
aA
aA
aA
aA
aA
aa
aa
aa
aa
aa
aa
aa
aa
aa
aa
aa
aa
aa
"}
(2,1,1) = {"
aa
aa
aa
aa
aa
aa
aa
aa
aa
aa
aa
aa
aa
aa
aa
aa
aM
aa
aa
aa
aa
aa
aa
aa
aA
aA
aA
aA
aA
aA
ab
ab
ab
ab
ab
ab
ab
aA
aA
aA
aa
aa
aa
aa
aM
aa
aa
aa
aa
aa
"}
(3,1,1) = {"
aa
aa
aa
aa
aa
aa
aa
aa
aa
aa
aa
aa
aa
aa
aa
aa
aa
aa
aa
aa
aa
aA
aA
aA
ab
ab
ab
ab
ab
ab
bt
bt
bt
bt
bt
bt
bt
ab
ab
ab
aA
aA
aa
aa
aa
aa
aW
aa
aM
aa
"}
(4,1,1) = {"
aa
aa
aa
aa
aa
aa
aa
aa
aa
aa
aa
aa
aa
aa
aa
aa
aa
aa
aa
aa
aA
ab
ab
ab
bt
bt
bt
bt
bt
bt
bt
bt
bt
bt
bt
bt
bt
bt
bt
bt
ab
ab
aA
aa
aa
aV
aI
aX
aa
aa
"}
(5,1,1) = {"
aa
aa
aa
aa
aa
aa
aa
aa
aa
aa
aa
aa
aa
aa
aA
aA
aA
aA
aA
aA
ab
bt
bt
bt
bt
bt
bt
bt
bt
bt
bt
bt
bt
bt
bt
bt
bt
bt
bt
bt
bt
bt
ab
aA
aa
aa
aa
aa
aa
aa
"}
(6,1,1) = {"
aa
aa
aa
aa
aa
aa
aa
aa
aa
aa
aa
aa
aa
aA
ab
ab
ab
ab
aA
ab
bt
bt
bt
bt
bt
bt
bt
bt
bt
bt
bt
bt
bt
bt
bt
bt
bt
bt
bt
bt
bt
bt
bt
ab
aA
aa
aM
aa
aa
aa
"}
(7,1,1) = {"
aa
aa
aa
aa
aa
aa
aa
aa
aa
aa
aM
aa
aA
ab
bt
bt
bt
bt
ab
bt
bt
bt
bt
bt
bt
bt
bt
bt
bt
bt
bt
bt
bt
bt
bt
bt
bt
bt
bt
bt
bt
bt
bt
bt
ab
aA
aa
aa
aa
aa
"}
(8,1,1) = {"
aa
aa
aa
aa
aa
aa
ab
aa
aa
aa
aa
aa
aA
ab
bt
bt
bt
bt
bt
bt
bt
bt
bt
bt
bt
bt
bt
bt
bt
bt
bt
bt
bt
bt
bt
ae
af
ae
bt
bt
bt
bt
bt
bt
bt
ab
aA
aa
aa
aa
"}
(9,1,1) = {"
aa
aa
aa
aa
aA
ab
ab
aA
aa
aa
aa
aa
aA
ab
bt
bt
bt
bt
bt
bt
bt
bt
bt
bt
bt
bt
bt
bt
bt
bt
bt
bt
bt
bt
bt
af
aq
af
bt
bt
bt
bt
bt
bt
bt
bt
ab
aA
aa
aa
"}
(10,1,1) = {"
aa
aa
aa
aa
ab
ab
ab
ab
aA
aa
aa
aA
aA
ab
bt
bt
bt
bt
bt
bt
bt
bt
bt
bt
bt
bt
bt
bt
bt
bt
bt
bt
bt
bt
ae
ae
ao
ae
ae
bt
bt
bt
bt
bt
bt
bt
ab
aA
aa
aa
"}
(11,1,1) = {"
aa
aa
aa
aA
ab
ab
ab
ab
aA
aa
aa
aA
aA
ab
bt
bt
bt
bt
bt
bt
bt
bt
bt
bt
bt
bt
bt
bt
bt
bt
bt
bt
bt
bt
af
an
an
an
af
bt
bt
bt
bt
bt
bt
bt
bt
ab
aA
aa
"}
(12,1,1) = {"
aa
aa
aa
aA
ab
ab
ab
ab
aA
aa
aa
aA
aA
aA
ab
bt
bt
bt
bt
bt
bt
bt
bt
bt
bt
bt
bt
bt
bt
bt
bt
bt
bt
ae
ae
bh
an
an
ae
ae
bt
bt
bt
bt
bt
bt
bt
ab
aA
aa
"}
(13,1,1) = {"
aa
aa
aa
aA
ab
ab
ab
ab
aA
aa
aa
aA
aA
aA
ab
bt
bt
bt
bt
bt
bt
bt
bt
bt
bt
bt
bt
bt
bt
bt
bt
bt
bt
af
aY
ao
ao
ao
ak
af
bt
bt
bt
bt
bt
bt
bt
ab
aA
aa
"}
(14,1,1) = {"
aa
aa
aa
aa
ab
ab
ab
ab
aA
aa
aa
aA
aA
aA
ab
bt
bt
bt
bt
bt
bt
bt
bt
bt
bt
bt
bt
bt
bt
bt
bt
bt
bt
al
aj
ap
an
as
aj
al
bt
bt
bt
bt
bt
bt
bt
ab
aA
aa
"}
(15,1,1) = {"
aa
aa
aa
aa
aA
ab
ab
aA
aa
aa
aa
aA
aA
aA
ab
bt
bt
bt
bt
bt
bt
bt
bt
bt
bt
bt
bt
bt
bt
bt
bt
bt
bt
af
ak
ao
ao
ao
ak
af
ac
bt
bt
bt
bt
bt
bt
ab
aA
aa
"}
(16,1,1) = {"
aa
aa
aa
aa
aa
aa
ab
aa
aa
aa
aa
aA
aA
ab
bt
bt
bt
bt
bt
bt
bt
bt
ah
az
bt
bt
bt
bt
bt
bt
bt
bt
aR
ae
ae
an
an
an
ae
ae
ac
bt
bt
bt
bt
bt
bt
ab
aA
aM
"}
(17,1,1) = {"
aa
aa
aa
aa
aa
aa
aa
aa
aa
aa
aa
aA
aA
ab
bt
bt
bt
bt
bt
bt
bt
bt
ac
ac
bt
bt
bt
bt
bt
bt
bt
bt
aR
ag
ag
af
ar
af
at
at
ac
bt
bt
bt
bt
bt
bt
ab
aA
aa
"}
(18,1,1) = {"
aa
aa
aa
aa
aa
aa
aa
aa
aa
aa
aa
aA
aA
ab
bt
bt
bt
bt
bt
bt
bt
ad
ac
ac
ac
ac
bt
aH
aJ
aL
bt
bt
aT
ac
ac
ac
ac
ac
ac
ac
aR
bt
bt
bt
bt
bt
bt
ab
aA
aa
"}
(19,1,1) = {"
aa
aa
aa
aa
aa
aa
aa
aa
aa
aa
aA
aA
ab
bt
bt
bt
bt
bt
bt
bt
bt
ad
au
ac
aB
am
ac
ac
ac
ac
bt
bt
ac
ac
ac
ac
ac
ac
ac
ac
bg
bt
bt
bt
bt
bt
bt
ab
aA
aa
"}
(20,1,1) = {"
aa
aa
aa
aa
aa
aa
aa
aa
aa
aa
aA
aA
ab
bt
bt
bt
bt
bt
bt
bt
bt
ad
aw
bs
aC
ac
ac
ac
ac
ac
bt
bt
bt
ac
ac
ac
ac
ac
ac
ac
bt
bt
bt
bt
bt
bt
bt
ab
aA
aa
"}
(21,1,1) = {"
aa
aa
aa
aa
aa
aa
aa
aM
aa
aa
aA
aA
ab
bt
bt
bt
bt
bt
bt
bt
bt
ad
ax
ac
aD
aF
ac
ac
ac
bt
bt
bt
aU
bd
ac
ac
bl
bm
ac
ac
bt
bt
bt
bt
bt
bt
bt
ab
aA
aa
"}
(22,1,1) = {"
aa
aa
aa
aa
aa
aa
aa
aa
aa
aa
aA
aA
ab
bt
bt
bt
bt
bt
bt
bt
bt
ad
ay
ac
ac
ac
aG
ac
ac
bt
bt
bt
av
be
ac
ac
ac
bn
bo
bo
bq
bt
bt
bt
bt
bt
bt
ab
aA
aa
"}
(23,1,1) = {"
aa
aa
aa
aa
aa
aa
aa
aa
aa
aa
aA
ab
bt
bt
bt
bt
bt
bt
bt
bt
bt
bt
ac
ac
ac
ac
ac
ac
ac
bt
bt
bt
bc
bf
ac
ac
ac
ac
ac
ac
br
bt
bt
bt
bt
bt
ab
aA
aa
aa
"}
(24,1,1) = {"
aa
aa
aa
aa
aa
aa
aa
aa
aa
aA
aA
ab
bt
bt
bt
bt
bt
bt
bt
bt
bt
bt
bt
ac
bt
ac
ac
ac
ac
ac
bt
bt
ac
ac
ac
ac
ac
ac
ac
ac
ac
bt
bt
bt
bt
bt
ab
aA
aa
aa
"}
(25,1,1) = {"
aa
aa
aa
aa
aa
aa
aa
aa
aa
aA
ab
bt
bt
bt
bt
bt
bt
bt
bt
bt
bt
bt
bt
bt
bt
ac
ac
ac
ac
ac
aN
ac
ac
ac
ac
aR
ac
ac
ac
ac
bt
bt
bt
bt
bt
ab
aA
aa
aa
aa
"}
(26,1,1) = {"
aa
aa
aa
aa
aa
aa
aa
aa
aa
aA
ab
bt
bt
bt
bt
bt
bt
bt
bt
bt
bt
bt
bt
bt
bt
bt
ac
ac
ac
bt
bt
ac
ac
ac
ac
ac
ac
ac
ac
ac
ac
ac
bt
bt
bt
ab
aa
aa
aa
aa
"}
(27,1,1) = {"
aa
aa
aa
aa
aa
aa
aa
aa
aa
aA
ab
bt
bt
bt
bt
bt
bt
bt
bt
bt
bt
bt
bt
bt
bt
bt
bt
bt
aK
bt
bt
ac
ac
ac
ac
ac
ac
ac
bp
ac
ac
aR
bt
bt
ab
aA
aa
aa
aa
aM
"}
(28,1,1) = {"
aa
aa
aa
aa
aa
aa
aa
aa
aa
aa
aA
ab
bt
bt
bt
bt
bt
bt
bt
bt
bt
bt
bt
bt
bt
bt
bt
bt
bt
bt
bt
aP
ac
ac
ac
ac
ac
ac
ac
ac
ac
aR
bt
bt
ab
aA
aa
aa
aa
aa
"}
(29,1,1) = {"
aa
aa
aa
aa
aa
aa
aa
aa
aa
aa
aA
ab
bt
bt
bt
bt
bt
bt
bt
bt
bt
bt
bt
bt
bt
bt
bt
bt
bt
bt
bt
aQ
aP
ac
ac
aR
ac
ac
ac
ac
bt
ac
bt
bt
ab
aA
aa
aa
aa
aa
"}
(30,1,1) = {"
aa
aa
aa
aa
aa
aa
aa
aa
aa
aa
aA
ab
bt
bt
bt
bt
bt
bt
bt
bt
bt
bt
bt
bt
bt
bt
bt
bt
bt
bt
bt
bt
bt
ac
ac
ac
ac
aP
ac
bg
bt
bt
bt
bt
ab
aa
aa
aa
aa
aa
"}
(31,1,1) = {"
aa
aa
aa
aa
aa
aa
aa
aa
aa
aa
aA
ab
ab
bt
bt
bt
bt
bt
bt
bt
bt
bt
bt
bt
bt
bt
bt
bt
bt
bt
bt
bt
bt
ac
ac
ac
ac
ac
ac
aS
bt
bt
bt
ab
aA
aa
aa
aa
ab
aA
"}
(32,1,1) = {"
aa
aa
aa
aa
aa
aa
aa
aa
aa
aa
aa
aA
aA
ab
bt
bt
bt
bt
bt
bt
bt
bt
bt
bt
bt
bt
bt
bt
bt
bt
bt
bt
bt
bg
ac
ac
ac
ac
ac
aS
bt
bt
bt
ab
aA
aa
aa
aO
ab
ab
"}
(33,1,1) = {"
aa
aa
aa
aa
aa
aa
aa
aa
aa
aa
aa
aa
aA
ab
bt
bt
bt
bt
bt
bt
bt
bt
bt
bt
bt
bt
bt
bt
bt
bt
bt
bt
bt
ac
ac
bj
ac
ac
ac
aS
bt
bt
bt
ab
aA
aa
aA
ab
ab
ab
"}
(34,1,1) = {"
aa
aa
aa
aa
aa
aa
aa
aa
aa
aa
aa
aa
aa
aA
ab
bt
bt
bt
bt
bt
bt
bt
bt
bt
bt
bt
bt
bt
bt
bt
bt
bt
bt
aS
bi
ac
ac
ac
aS
aS
bt
bt
bt
ab
aA
aa
aA
ab
ab
aA
"}
(35,1,1) = {"
aa
aa
aa
aa
aa
aa
aA
aA
aa
aa
aa
aa
aM
aa
aA
ab
bt
bt
bt
bt
bt
bt
bt
bt
bt
bt
bt
bt
bt
bt
bt
ab
bt
aS
ac
ac
ac
ac
aS
aS
bt
bt
ab
aA
aa
aa
aA
ab
ab
ab
"}
(36,1,1) = {"
aa
aa
aa
aa
aa
aa
ab
ab
aA
aa
aa
aa
aa
aa
aA
ab
bt
bt
bt
bt
bt
bt
bt
bt
bt
bt
bt
bt
bt
bt
ab
aA
aS
aS
aS
bk
bk
aS
aS
aS
aS
ab
ab
aA
aa
aa
aa
ab
ab
ab
"}
(37,1,1) = {"
aa
aa
aa
aa
aa
ab
ab
ab
ab
aa
aa
aa
aa
aa
aA
aA
ab
bt
bt
bt
bt
bt
bt
bt
bt
bt
bt
bt
bt
ab
aA
aA
aA
aS
aS
aS
bk
aS
aS
aS
aA
aA
ab
aA
aa
aa
aa
aa
aA
aA
"}
(38,1,1) = {"
aa
aa
aa
aa
aa
ab
ab
ab
ab
ab
aa
aa
aa
aa
aa
aA
aA
ab
bt
bt
bt
bt
bt
bt
bt
bt
bt
bt
bt
ab
aA
aA
ai
ai
ai
ai
ai
ai
ai
ai
aA
aA
ab
aA
aa
aa
aa
aa
aa
aa
"}
(39,1,1) = {"
aa
aa
aa
aa
aa
aA
ab
ab
ab
ab
aa
aa
aa
aa
aa
aa
aA
aA
ab
bt
bt
bt
bt
bt
bt
bt
bt
bt
bt
ab
aA
aa
aa
aa
ai
ai
ai
aa
ai
aa
aa
aA
ab
aA
aa
aa
aa
aa
aa
aa
"}
(40,1,1) = {"
aa
aa
aa
aa
aa
aa
aA
ab
ab
aA
aa
aa
aa
aa
aa
aa
aa
aA
aA
ab
bt
bt
bt
bt
bt
bt
bt
bt
bt
bt
ab
ab
aa
aa
aa
aa
aa
aa
ai
aa
aa
ab
ab
aA
aa
aa
aa
aa
aa
aa
"}
(41,1,1) = {"
aa
aa
aa
aa
aa
aa
aa
aa
aa
aa
aa
aa
aa
aa
aa
aa
aa
aa
aA
aA
ab
ab
ab
ab
ab
ab
ab
ab
bt
bt
bt
ab
aa
aa
aa
aa
aa
aa
aa
aa
aa
ab
ab
aA
aa
aa
aa
aa
aa
aa
"}
(42,1,1) = {"
aa
aa
aa
aa
aa
aa
aa
aa
aa
aa
aa
aa
aa
aa
aa
aa
aa
aa
aa
aA
aA
aA
aA
aA
aA
aA
aA
aA
ab
ab
ab
ab
ab
aa
aa
aa
aa
aa
aa
aa
aa
ab
aa
aa
aa
aa
aM
aa
aa
aa
"}
(43,1,1) = {"
aa
aa
aa
aa
aa
aa
aa
aa
aa
aa
aa
aa
aa
aa
aa
aa
aa
aa
aa
aa
aa
aa
aa
aa
aa
aa
aa
aA
aA
aA
aA
aA
ab
aa
aa
aa
aa
aa
aa
aa
aa
aa
aa
aa
aa
aa
aa
aa
aa
aa
"}
(44,1,1) = {"
aa
aa
aa
aa
aa
aa
aa
aa
aa
aa
aa
aa
aa
aa
aa
aa
aa
aa
aa
aa
aa
aa
aa
aa
aa
aa
aa
aa
aa
aa
aa
aa
aa
aa
aa
aa
aa
aa
aa
aa
aa
aa
aa
aa
aa
aa
ac
aa
aa
aa
"}
(45,1,1) = {"
aa
aa
aa
aa
aa
aa
aa
aa
aa
aa
aa
aa
aa
aa
aA
aa
aa
aa
aa
aM
aa
aa
aa
aa
aa
aa
aa
aM
aa
aa
aa
aa
aa
aa
aa
aa
aa
aa
aa
aa
aM
aa
aa
aa
aa
ac
ab
ac
aa
aa
"}
(46,1,1) = {"
aa
aa
aa
aa
aa
aa
aa
aa
aa
aa
aa
aa
aa
aM
ab
ab
aA
aa
aa
aa
aa
aa
aa
aa
aa
aa
aa
aa
aa
aa
aa
aa
aa
aa
aa
aa
aa
aa
aa
aa
aa
aa
aa
aa
aa
ab
ab
ab
aa
aa
"}
(47,1,1) = {"
aa
aa
aa
aa
aa
aa
aa
aa
aa
aa
aa
aa
aa
ab
ab
ab
ab
aA
aa
aa
aa
aa
aa
aa
aa
aa
aa
aa
aa
aa
aa
aa
aA
aA
aa
aa
aa
aa
aa
aa
aa
aa
aa
aa
aa
ab
ab
ab
aa
aa
"}
(48,1,1) = {"
aa
aa
aa
aa
aa
aa
aa
aa
aa
aa
aa
aa
aa
aA
ab
ab
ab
ab
aa
aa
aa
aM
aa
aa
aa
aa
aa
aa
aa
aa
aa
aA
ab
aA
aa
aa
aa
aa
aa
aa
aa
aa
aa
aa
aa
ac
ab
ac
aa
aa
"}
(49,1,1) = {"
aa
aa
aa
aa
aa
aa
aa
aa
aa
aa
aa
aa
aa
aa
aa
aA
aA
aa
aa
aa
aa
aa
aa
aa
aa
aa
aa
aa
aa
aa
aa
aa
aA
aa
aa
aa
aa
aM
aa
aa
aa
aa
aa
aa
aa
ac
aa
aa
aa
aa
"}
(50,1,1) = {"
aa
aa
aa
aa
aa
aa
aa
aa
aa
aa
aa
aa
aa
aa
aa
aa
aa
aa
aa
aa
aa
aa
aa
aa
aa
aa
aa
aa
aa
aa
aa
aa
aa
aa
aa
aa
aa
aa
aa
aa
aa
aa
aa
aa
aa
bt
aa
aa
aa
aa
"}
