//MAP CONVERTED BY dmm2tgm.py THIS HEADER COMMENT PREVENTS RECONVERSION, DO NOT REMOVE
"a" = (
/turf/template_noop,
/area/template_noop)
"b" = (
/turf/closed/wall/mineral/titanium,
/area/shuttle/arrival)
"c" = (
/obj/structure/shuttle/engine/propulsion/right{
	dir = 1
	},
/turf/open/floor/plating,
/area/shuttle/arrival)
"d" = (
/obj/structure/shuttle/engine/propulsion/left{
	dir = 1
	},
/turf/open/floor/plating,
/area/shuttle/arrival)
"e" = (
/turf/closed/wall/mineral/titanium/nosmooth,
/area/shuttle/arrival)
"f" = (
/obj/structure/shuttle/engine/heater{
	dir = 1
	},
/obj/structure/window/reinforced/spawner,
/turf/open/floor/plating,
/area/shuttle/arrival)
"g" = (
/obj/structure/shuttle/engine/heater{
	dir = 1
	},
/turf/closed/wall/mineral/titanium/nosmooth,
/area/shuttle/arrival)
"h" = (
/obj/machinery/sleeper,
/obj/machinery/light{
	dir = 8;
	light_color = "#e8eaff"
	},
/turf/open/floor/mineral/titanium/white,
/area/shuttle/arrival)
"i" = (
/obj/structure/closet/emcloset/anchored,
/turf/open/floor/mineral/titanium/white,
/area/shuttle/arrival)
"j" = (
/obj/structure/table/reinforced,
/obj/item/radio,
/obj/item/storage/toolbox/emergency,
/turf/open/floor/mineral/titanium/white,
/area/shuttle/arrival)
"k" = (
/turf/open/floor/mineral/titanium/blue,
/area/shuttle/arrival)
"l" = (
/obj/structure/window/shuttle,
/obj/structure/grille,
/turf/open/floor/plating,
/area/shuttle/arrival)
"m" = (
/obj/structure/chair/comfy/shuttle,
/turf/open/floor/mineral/titanium/blue,
/area/shuttle/arrival)
"n" = (
/obj/machinery/door/airlock/external{
	name = "Arrival Shuttle Airlock"
	},
/obj/structure/fans/tiny,
/turf/open/floor/plating,
/area/shuttle/arrival)
"o" = (
/obj/structure/table/reinforced,
/obj/item/storage/firstaid/regular,
/turf/open/floor/mineral/titanium/blue,
/area/shuttle/arrival)
"p" = (
/obj/structure/table/reinforced,
/obj/item/storage/toolbox/emergency,
/turf/open/floor/mineral/titanium/blue,
/area/shuttle/arrival)
"q" = (
/obj/structure/table/reinforced,
/turf/open/floor/mineral/titanium/blue,
/area/shuttle/arrival)
"r" = (
/obj/structure/table/reinforced,
/obj/item/radio,
/turf/open/floor/mineral/titanium/blue,
/area/shuttle/arrival)
"s" = (
/obj/machinery/computer{
	dir = 1;
	name = "Shuttle computer"
	},
/turf/open/floor/mineral/titanium/blue,
/area/shuttle/arrival)
"t" = (
/obj/machinery/sleeper,
/obj/machinery/light{
	dir = 4
	},
/turf/open/floor/mineral/titanium/white,
/area/shuttle/arrival)
"u" = (
/obj/structure/chair/comfy/shuttle,
/obj/machinery/light{
	dir = 8;
	light_color = "#e8eaff"
	},
/turf/open/floor/mineral/titanium/blue,
/area/shuttle/arrival)
"v" = (
/obj/structure/chair/comfy/shuttle,
/obj/machinery/light{
	dir = 4
	},
/turf/open/floor/mineral/titanium/blue,
/area/shuttle/arrival)
"w" = (
/obj/machinery/computer{
	dir = 1;
	name = "Shuttle computer"
	},
/obj/machinery/light{
	dir = 8;
	light_color = "#e8eaff"
	},
/turf/open/floor/mineral/titanium/blue,
/area/shuttle/arrival)
"x" = (
/obj/machinery/computer{
	dir = 1;
	name = "Shuttle computer"
	},
/obj/machinery/light{
	dir = 4
	},
/turf/open/floor/mineral/titanium/blue,
/area/shuttle/arrival)
"y" = (
/obj/docking_port/mobile/arrivals{
	dir = 2;
	dwidth = 4;
	height = 12;
	name = "cog arrivals shuttle";
	width = 9
	},
/turf/template_noop,
/area/template_noop)

(1,1,1) = {"
a
c
g
b
a
a
a
a
a
a
a
a
"}
(2,1,1) = {"
b
e
b
b
l
b
b
n
b
b
b
a
"}
(3,1,1) = {"
c
f
h
k
m
m
u
k
o
q
b
b
"}
(4,1,1) = {"
d
f
i
k
m
m
m
k
m
m
w
l
"}
(5,1,1) = {"
y
e
j
k
k
k
k
k
k
k
s
l
"}
(6,1,1) = {"
c
f
i
k
m
m
m
k
m
m
x
l
"}
(7,1,1) = {"
d
f
t
k
m
m
v
k
p
r
b
b
"}
(8,1,1) = {"
b
e
b
b
l
b
b
n
b
b
b
a
"}
(9,1,1) = {"
a
d
g
b
a
a
a
a
a
a
a
a
"}
