//MAP CONVERTED BY dmm2tgm.py THIS HEADER COMMENT PREVENTS RECONVERSION, DO NOT REMOVE
"a" = (
/turf/template_noop,
/area/template_noop)
"b" = (
/turf/closed/wall/mineral/titanium,
/area/shuttle/arrival)
"c" = (
/obj/machinery/door/airlock/titanium{
	name = "Arrivals Shuttle Airlock"
	},
/obj/structure/fans/tiny,
/turf/open/floor/mineral/titanium/blue,
/area/shuttle/arrival)
"d" = (
/obj/effect/spawner/structure/window/shuttle,
/turf/open/floor/plating,
/area/shuttle/arrival)
"e" = (
/obj/structure/closet/wardrobe/black,
/turf/open/floor/mineral/titanium/blue,
/area/shuttle/arrival)
"f" = (
/turf/open/floor/mineral/titanium/blue,
/area/shuttle/arrival)
"g" = (
/obj/machinery/computer/arcade,
/turf/open/floor/mineral/titanium/blue,
/area/shuttle/arrival)
"h" = (
/obj/structure/closet/wardrobe/grey,
/obj/machinery/light/small{
	dir = 1
	},
/turf/open/floor/mineral/titanium/blue,
/area/shuttle/arrival)
"i" = (
/obj/structure/closet/wardrobe/green,
/turf/open/floor/mineral/titanium/blue,
/area/shuttle/arrival)
"j" = (
/obj/machinery/requests_console{
	department = "Arrival shuttle";
	name = "Arrivals Shuttle console";
	pixel_y = 30
	},
/obj/machinery/light{
	dir = 1
	},
/turf/open/floor/mineral/titanium/blue,
/area/shuttle/arrival)
"k" = (
/obj/structure/shuttle/engine/heater{
	dir = 4
	},
/obj/structure/window/reinforced{
	dir = 8
	},
/turf/open/floor/plating/airless,
/area/shuttle/arrival)
"m" = (
/obj/machinery/light{
	dir = 1
	},
/obj/structure/closet/wardrobe/mixed,
/turf/open/floor/mineral/titanium/blue,
/area/shuttle/arrival)
"n" = (
/obj/docking_port/mobile/arrivals{
	name = "Snaxi Arrivals Shuttle"
	},
/obj/structure/shuttle/engine/propulsion/burst/right{
	dir = 4
	},
/turf/open/floor/plating/airless,
/area/shuttle/arrival)
"o" = (
/obj/structure/table,
/obj/item/storage/firstaid/regular,
/obj/machinery/light/small,
/turf/open/floor/mineral/titanium/blue,
/area/shuttle/arrival)
"p" = (
/obj/structure/table,
/obj/item/storage/toolbox/emergency,
/turf/open/floor/mineral/titanium/blue,
/area/shuttle/arrival)
"q" = (
/obj/machinery/light,
/turf/open/floor/mineral/titanium/blue,
/area/shuttle/arrival)
"r" = (
/obj/structure/chair/comfy/shuttle{
	dir = 8
	},
/turf/open/floor/mineral/titanium,
/area/shuttle/arrival)
"s" = (
/obj/item/radio/intercom{
	name = "Station Intercom (General)";
	pixel_y = -29
	},
/obj/machinery/light,
/turf/open/floor/mineral/titanium/blue,
/area/shuttle/arrival)
"x" = (
/obj/structure/closet/emcloset,
/turf/open/floor/mineral/titanium/blue,
/area/shuttle/arrival)
"z" = (
/obj/structure/shuttle/engine/propulsion/burst/right{
	dir = 4
	},
/turf/open/floor/plating/airless,
/area/shuttle/arrival)

(1,1,1) = {"
a
b
d
d
d
b
a
"}
(2,1,1) = {"
b
b
r
r
r
b
b
"}
(3,1,1) = {"
b
h
f
f
f
o
b
"}
(4,1,1) = {"
b
i
r
r
r
p
b
"}
(5,1,1) = {"
b
e
f
f
f
x
b
"}
(6,1,1) = {"
b
m
r
r
r
q
b
"}
(7,1,1) = {"
d
g
f
f
f
f
d
"}
(8,1,1) = {"
c
f
r
r
r
f
c
"}
(9,1,1) = {"
c
f
f
f
f
f
c
"}
(10,1,1) = {"
b
j
r
r
r
s
b
"}
(11,1,1) = {"
b
k
k
k
k
k
b
"}
(12,1,1) = {"
b
z
z
n
z
z
b
"}
