"a" = (/turf/template_noop,/area/template_noop)
"b" = (/turf/closed/wall/mineral/titanium,/area/shuttle/arrival)
"c" = (/obj/structure/shuttle/engine/propulsion/right{dir = 1},/turf/open/floor/plating,/area/shuttle/arrival)
"d" = (/obj/structure/shuttle/engine/propulsion/left{dir = 1},/turf/open/floor/plating,/area/shuttle/arrival)
"e" = (/obj/docking_port/mobile/arrivals{dir = 2; dwidth = 4; height = 12; name = "cog arrivals shuttle"; width = 9},/turf/template_noop,/area/template_noop)
"f" = (/turf/closed/wall/mineral/titanium/nosmooth,/area/shuttle/arrival)
"g" = (/obj/structure/shuttle/engine/heater{dir = 1},/obj/structure/window/reinforced/spawner,/turf/open/floor/plating,/area/shuttle/arrival)
"h" = (/obj/structure/shuttle/engine/heater{dir = 1},/turf/closed/wall/mineral/titanium/nosmooth,/area/shuttle/arrival)
"i" = (/obj/machinery/sleeper,/obj/machinery/light{dir = 8; light_color = "#e8eaff"},/turf/open/floor/mineral/titanium/white,/area/shuttle/arrival)
"j" = (/obj/structure/closet/emcloset/anchored,/turf/open/floor/mineral/titanium/white,/area/shuttle/arrival)
"k" = (/obj/structure/table/reinforced,/obj/item/radio,/obj/item/storage/toolbox/emergency,/turf/open/floor/mineral/titanium/white,/area/shuttle/arrival)
"l" = (/obj/machinery/sleeper,/obj/machinery/light{dir = 4},/turf/open/floor/mineral/titanium/white,/area/shuttle/arrival)
"m" = (/turf/open/floor/mineral/titanium/blue,/area/shuttle/arrival)
"n" = (/obj/structure/window/shuttle,/obj/structure/grille,/turf/open/floor/plating,/area/shuttle/arrival)
"o" = (/obj/structure/chair/comfy/shuttle,/turf/open/floor/mineral/titanium/blue,/area/shuttle/arrival)
"p" = (/obj/structure/chair/comfy/shuttle,/obj/machinery/light{dir = 8; light_color = "#e8eaff"},/turf/open/floor/mineral/titanium/blue,/area/shuttle/arrival)
"q" = (/obj/structure/chair/comfy/shuttle,/obj/machinery/light{dir = 4},/turf/open/floor/mineral/titanium/blue,/area/shuttle/arrival)
"r" = (/obj/machinery/door/airlock/external{name = "Arrival Shuttle Airlock"},/obj/structure/fans/tiny,/turf/open/floor/plating,/area/shuttle/arrival)
"s" = (/obj/structure/table/reinforced,/obj/item/storage/firstaid/regular,/turf/open/floor/mineral/titanium/blue,/area/shuttle/arrival)
"t" = (/obj/structure/table/reinforced,/obj/item/storage/toolbox/emergency,/turf/open/floor/mineral/titanium/blue,/area/shuttle/arrival)
"u" = (/obj/structure/table/reinforced,/turf/open/floor/mineral/titanium/blue,/area/shuttle/arrival)
"v" = (/obj/structure/table/reinforced,/obj/item/radio,/turf/open/floor/mineral/titanium/blue,/area/shuttle/arrival)
"w" = (/obj/machinery/computer{dir = 1; name = "Shuttle computer"},/obj/machinery/light{dir = 8; light_color = "#e8eaff"},/turf/open/floor/mineral/titanium/blue,/area/shuttle/arrival)
"x" = (/obj/machinery/computer{dir = 1; name = "Shuttle computer"},/turf/open/floor/mineral/titanium/blue,/area/shuttle/arrival)
"y" = (/obj/machinery/computer{dir = 1; name = "Shuttle computer"},/obj/machinery/light{dir = 4},/turf/open/floor/mineral/titanium/blue,/area/shuttle/arrival)

(1,1,1) = {"
abcdecdba
cfggfggfd
hbijkjlbh
bbmmmmmbb
anoomoona
aboomooba
abpomoqba
armmmmmra
absomotba
abuomovba
abbwxybba
aabnnnbaa
"}
