//MAP CONVERTED BY dmm2tgm.py THIS HEADER COMMENT PREVENTS RECONVERSION, DO NOT REMOVE
"a" = (
/turf/template_noop,
/area/template_noop)
"c" = (
/obj/structure/extinguisher_cabinet{
	pixel_x = -26
	},
/obj/effect/turf_decal/tile/neutral{
	dir = 4
	},
/obj/item/kirbyplants/random,
/turf/open/floor/plasteel,
/area/shuttle/arrival)
"g" = (
/obj/machinery/door/airlock/shuttle/glass,
/turf/open/floor/plasteel,
/area/shuttle/arrival)
"h" = (
/obj/machinery/computer{
	dir = 1;
	name = "Shuttle computer"
	},
/turf/open/floor/plasteel,
/area/shuttle/arrival)
"i" = (
/obj/structure/shuttle/engine/heater{
	dir = 1
	},
/obj/structure/window/reinforced,
/obj/effect/turf_decal/stripes/line{
	dir = 1
	},
/turf/open/floor/plasteel/airless,
/area/shuttle/arrival)
"j" = (
/obj/effect/turf_decal/caution{
	dir = 4
	},
/obj/effect/turf_decal/tile/neutral,
/obj/effect/turf_decal/tile/neutral{
	dir = 4
	},
/obj/structure/table/reinforced,
/obj/machinery/cell_charger,
/obj/machinery/light{
	dir = 8
	},
/turf/open/floor/plasteel,
/area/shuttle/arrival)
"m" = (
/obj/structure/table/reinforced,
/obj/item/radio/intercom{
	pixel_x = -30
	},
/obj/item/paper_bin,
/obj/item/pen,
/turf/open/floor/plasteel,
/area/shuttle/arrival)
"n" = (
/obj/machinery/light{
	dir = 4
	},
/obj/effect/turf_decal/tile/neutral{
	dir = 1
	},
/obj/effect/turf_decal/tile/neutral{
	dir = 8
	},
/turf/open/floor/plasteel,
/area/shuttle/arrival)
"p" = (
/obj/effect/turf_decal/tile/neutral{
	dir = 1
	},
/obj/effect/turf_decal/caution{
	dir = 8
	},
/turf/open/floor/plasteel,
/area/shuttle/arrival)
"t" = (
/turf/closed/wall/mineral/titanium,
/area/shuttle/arrival)
"u" = (
/obj/effect/turf_decal/tile/neutral{
	dir = 4
	},
/obj/structure/closet/crate/internals,
/obj/item/storage/firstaid/o2,
/obj/item/tank/internals/emergency_oxygen,
/obj/item/tank/internals/emergency_oxygen,
/obj/item/tank/internals/emergency_oxygen,
/obj/item/tank/internals/emergency_oxygen,
/obj/item/clothing/mask/breath,
/obj/item/clothing/mask/breath,
/obj/item/clothing/mask/breath,
/obj/item/clothing/mask/breath,
/obj/effect/turf_decal/delivery,
/turf/open/floor/plasteel,
/area/shuttle/arrival)
"v" = (
/obj/structure/chair/comfy/shuttle{
	dir = 4
	},
/obj/effect/turf_decal/bot,
/turf/open/floor/plasteel,
/area/shuttle/arrival)
"w" = (
/obj/structure/closet/wardrobe/grey{
	anchored = 1
	},
/obj/effect/turf_decal/delivery,
/obj/effect/turf_decal/tile/neutral,
/turf/open/floor/plasteel,
/area/shuttle/arrival)
"y" = (
/obj/effect/turf_decal/tile/neutral{
	dir = 1
	},
/obj/effect/turf_decal/tile/neutral,
/obj/effect/turf_decal/tile/neutral{
	dir = 4
	},
/obj/effect/turf_decal/tile/neutral{
	dir = 8
	},
/turf/open/floor/plasteel,
/area/shuttle/arrival)
"z" = (
/obj/effect/turf_decal/tile/neutral{
	dir = 1
	},
/obj/effect/turf_decal/tile/neutral{
	dir = 8
	},
/obj/effect/turf_decal/caution{
	dir = 8
	},
/turf/open/floor/plasteel,
/area/shuttle/arrival)
"C" = (
/obj/effect/turf_decal/tile/neutral{
	dir = 1
	},
/turf/open/floor/plasteel,
/area/shuttle/arrival)
"E" = (
/obj/effect/turf_decal/tile/neutral{
	dir = 1
	},
/obj/effect/turf_decal/tile/neutral{
	dir = 4
	},
/turf/open/floor/plasteel,
/area/shuttle/arrival)
"G" = (
/obj/structure/closet/emcloset{
	anchored = 1
	},
/obj/machinery/vending/wallmed{
	pixel_y = 32
	},
/obj/item/storage/toolbox/emergency,
/obj/item/storage/toolbox/emergency,
/obj/item/clothing/suit/hazardvest,
/obj/item/clothing/suit/hazardvest,
/obj/item/clothing/suit/hazardvest,
/obj/item/clothing/suit/hazardvest,
/obj/item/clothing/head/hardhat/orange,
/obj/item/clothing/head/hardhat/orange,
/obj/item/clothing/head/hardhat/orange,
/obj/item/clothing/head/hardhat/orange,
/obj/effect/turf_decal/delivery,
/obj/effect/turf_decal/tile/neutral,
/obj/effect/turf_decal/tile/neutral{
	dir = 8
	},
/turf/open/floor/plasteel,
/area/shuttle/arrival)
"H" = (
/obj/structure/shuttle/engine/propulsion{
	dir = 1
	},
/obj/effect/turf_decal/stripes/line{
	dir = 1
	},
/turf/open/floor/plasteel/airless,
/area/shuttle/arrival)
"K" = (
/obj/structure/closet/wardrobe/mixed{
	anchored = 1
	},
/obj/effect/turf_decal/delivery,
/obj/effect/turf_decal/tile/neutral{
	dir = 8
	},
/turf/open/floor/plasteel,
/area/shuttle/arrival)
"L" = (
/obj/structure/sign/nanotrasen,
/turf/closed/wall/mineral/titanium,
/area/shuttle/arrival)
"N" = (
/obj/structure/table/reinforced,
/obj/item/storage/dice{
	pixel_x = -2;
	pixel_y = 8
	},
/obj/item/toy/cards/deck,
/obj/machinery/requests_console{
	department = "Arrival shuttle";
	name = "Arrival shuttle requests console";
	pixel_x = 32
	},
/turf/open/floor/plasteel,
/area/shuttle/arrival)
"O" = (
/turf/closed/wall/mineral/titanium/nodiagonal,
/area/shuttle/arrival)
"Q" = (
/obj/structure/chair/comfy/shuttle{
	dir = 8
	},
/obj/effect/turf_decal/bot,
/turf/open/floor/plasteel,
/area/shuttle/arrival)
"R" = (
/obj/effect/turf_decal/tile/neutral,
/obj/effect/turf_decal/tile/neutral{
	dir = 4
	},
/obj/structure/sign/poster/official/enlist{
	pixel_x = -32
	},
/turf/open/floor/plasteel,
/area/shuttle/arrival)
"U" = (
/obj/machinery/door/airlock/shuttle,
/obj/structure/fans/tiny,
/obj/effect/turf_decal/stripes/line{
	dir = 8
	},
/obj/effect/turf_decal/stripes/line{
	dir = 4
	},
/turf/open/floor/plating,
/area/shuttle/arrival)
"W" = (
/obj/docking_port/mobile/arrivals{
	dir = 2;
	dwidth = 2;
	height = 16;
	name = "omega arrivals shuttle";
	width = 5
	},
/turf/closed/wall/mineral/plastitanium/nodiagonal,
/area/shuttle/arrival)
"X" = (
/obj/machinery/door/airlock/shuttle,
/obj/effect/turf_decal/stripes/line{
	dir = 4
	},
/obj/effect/turf_decal/stripes/line{
	dir = 8
	},
/obj/structure/fans/tiny,
/turf/open/floor/plating,
/area/shuttle/arrival)
"Y" = (
/obj/machinery/light/small{
	dir = 4
	},
/obj/structure/chair/office/light,
/turf/open/floor/plasteel,
/area/shuttle/arrival)
"Z" = (
/obj/effect/spawner/structure/window/shuttle,
/turf/open/floor/plating,
/area/shuttle/arrival)

(1,1,1) = {"
a
O
t
t
t
Z
Z
O
Z
Z
t
L
t
a
a
a
"}
(2,1,1) = {"
H
i
w
R
c
v
v
m
v
v
j
u
t
t
Z
Z
"}
(3,1,1) = {"
W
O
G
y
y
y
y
y
y
y
y
E
g
Y
h
Z
"}
(4,1,1) = {"
H
i
K
n
p
Q
Q
N
Q
Q
z
C
t
t
Z
Z
"}
(5,1,1) = {"
a
O
t
t
U
Z
Z
O
Z
Z
X
L
t
a
a
a
"}
