//MAP CONVERTED BY dmm2tgm.py THIS HEADER COMMENT PREVENTS RECONVERSION, DO NOT REMOVE
"a" = (
/turf/template_noop,
/area/template_noop)
"b" = (
/obj/structure/shuttle/engine/propulsion{
	dir = 1
	},
/obj/effect/turf_decal/stripes/line{
	dir = 1
	},
/turf/open/floor/plating/airless,
/area/shuttle/escape)
"c" = (
/turf/closed/wall/mineral/plastitanium,
/area/shuttle/escape)
"d" = (
/obj/structure/window/reinforced,
/obj/structure/shuttle/engine/heater{
	dir = 1
	},
/obj/effect/turf_decal/stripes/line{
	dir = 1
	},
/turf/open/floor/plating/airless,
/area/shuttle/escape)
"e" = (
/turf/closed/wall,
/area/shuttle/escape)
"f" = (
/turf/open/floor/plating,
/area/shuttle/escape)
"g" = (
/obj/docking_port/mobile/emergency/shuttle_build{
	dwidth = 11;
	height = 18;
	name = "Shuttle Under Construction";
	port_direction = 4;
	preferred_direction = 2;
	width = 30
	},
/obj/machinery/door/airlock,
/obj/structure/fans/tiny,
/turf/open/floor/plating,
/area/shuttle/escape)
"h" = (
/obj/machinery/computer/emergency_shuttle{
	dir = 1
	},
/turf/open/floor/plating,
/area/shuttle/escape)
"K" = (
/obj/machinery/door/airlock,
/obj/structure/fans/tiny,
/turf/open/floor/plating,
/area/shuttle/escape)

(1,1,1) = {"
a
c
e
e
e
e
e
e
e
K
e
g
e
e
e
e
e
K
e
K
e
e
e
e
a
a
a
a
a
"}
(2,1,1) = {"
b
d
f
f
f
f
f
f
f
f
f
f
f
f
f
f
f
f
f
f
f
f
f
e
a
a
a
a
a
"}
(3,1,1) = {"
b
d
f
f
f
f
f
f
f
f
f
f
f
f
f
f
f
f
f
f
f
f
f
e
a
a
a
a
a
"}
(4,1,1) = {"
b
d
f
f
f
f
f
f
f
f
f
f
f
f
f
f
f
f
f
f
f
f
f
e
a
a
a
a
a
"}
(5,1,1) = {"
c
c
f
f
f
f
f
f
f
f
f
f
f
f
f
f
f
f
f
f
f
f
f
e
e
e
e
e
e
"}
(6,1,1) = {"
b
d
f
f
f
f
f
f
f
f
f
f
f
f
f
f
f
f
f
f
f
f
f
f
f
f
f
f
e
"}
(7,1,1) = {"
b
d
f
f
f
f
f
f
f
f
f
f
f
f
f
f
f
f
f
f
f
f
f
f
f
f
f
f
e
"}
(8,1,1) = {"
c
c
f
f
f
f
f
f
f
f
f
f
f
f
f
f
f
f
f
f
f
f
f
f
f
f
f
f
e
"}
(9,1,1) = {"
b
d
f
f
f
f
f
f
f
f
f
f
f
f
f
f
f
f
f
f
f
f
f
f
f
f
f
h
e
"}
(10,1,1) = {"
b
d
f
f
f
f
f
f
f
f
f
f
f
f
f
f
f
f
f
f
f
f
f
f
f
f
f
f
e
"}
(11,1,1) = {"
c
c
f
f
f
f
f
f
f
f
f
f
f
f
f
f
f
f
f
f
f
f
f
f
f
f
f
f
e
"}
(12,1,1) = {"
b
d
f
f
f
f
f
f
f
f
f
f
f
f
f
f
f
f
f
f
f
f
f
f
f
f
f
f
e
"}
(13,1,1) = {"
b
d
f
f
f
f
f
f
f
f
f
f
f
f
f
f
f
f
f
f
f
f
f
f
f
f
f
f
e
"}
(14,1,1) = {"
c
c
f
f
f
f
f
f
f
f
f
f
f
f
f
f
f
f
f
f
f
f
f
e
e
e
e
e
e
"}
(15,1,1) = {"
b
d
f
f
f
f
f
f
f
f
f
f
f
f
f
f
f
f
f
f
f
f
f
e
a
a
a
a
a
"}
(16,1,1) = {"
b
d
f
f
f
f
f
f
f
f
f
f
f
f
f
f
f
f
f
f
f
f
f
e
a
a
a
a
a
"}
(17,1,1) = {"
b
d
f
f
f
f
f
f
f
f
f
f
f
f
f
f
f
f
f
f
f
f
f
e
a
a
a
a
a
"}
(18,1,1) = {"
a
c
e
e
e
e
e
e
e
e
e
e
e
e
e
e
e
e
e
e
e
e
e
e
a
a
a
a
a
"}
