//MAP CONVERTED BY dmm2tgm.py THIS HEADER COMMENT PREVENTS RECONVERSION, DO NOT REMOVE
"a" = (
/turf/template_noop,
/area/template_noop)
"b" = (
/obj/structure/shuttle/engine/propulsion{
	dir = 4
	},
/turf/open/floor/plating,
/area/shuttle/escape)
"c" = (
/obj/structure/shuttle/engine/heater{
	dir = 8
	},
/obj/structure/window/reinforced{
	dir = 1
	},
/turf/open/floor/plating,
/area/shuttle/escape)
"d" = (
/turf/closed/wall/mineral/titanium,
/area/shuttle/escape)
"e" = (
/obj/machinery/light{
	dir = 1
	},
/obj/structure/chair/comfy/shuttle{
	dir = 4
	},
/turf/open/floor/mineral/titanium/blue,
/area/shuttle/escape)
"f" = (
/obj/machinery/status_display/evac,
/turf/closed/wall/mineral/titanium,
/area/shuttle/escape)
"g" = (
/obj/machinery/door/airlock/titanium{
	name = "Emergency Shuttle Airlock"
	},
/obj/structure/fans/tiny,
/turf/open/floor/plating,
/area/shuttle/escape)
"h" = (
/obj/structure/table/reinforced,
/turf/open/floor/mineral/titanium/blue,
/area/shuttle/escape)
"i" = (
/obj/machinery/light{
	dir = 4
	},
/turf/open/floor/mineral/titanium,
/area/shuttle/escape)
"j" = (
/obj/structure/table/reinforced,
/obj/item/storage/toolbox/emergency,
/obj/structure/window/reinforced{
	dir = 1
	},
/turf/open/floor/mineral/titanium/yellow,
/area/shuttle/escape)
"k" = (
/obj/structure/chair/comfy/brown{
	dir = 4
	},
/turf/open/floor/mineral/titanium/yellow,
/area/shuttle/escape)
"l" = (
/obj/machinery/vending/wallmed,
/turf/closed/wall/mineral/titanium,
/area/shuttle/escape)
"m" = (
/obj/effect/spawner/structure/window/shuttle,
/turf/open/floor/plating,
/area/shuttle/escape)
"n" = (
/turf/open/floor/mineral/titanium/white,
/area/shuttle/escape)
"o" = (
/obj/machinery/door/airlock/titanium{
	name = "Emergency Shuttle Airlock"
	},
/obj/structure/fans/tiny,
/obj/docking_port/mobile/emergency{
	dheight = 0;
	dir = 2;
	dwidth = 9;
	name = "NES Classic";
	width = 22
	},
/turf/open/floor/plating,
/area/shuttle/escape)
"p" = (
/obj/structure/shuttle/engine/heater{
	dir = 8
	},
/obj/structure/window/reinforced{
	dir = 4
	},
/turf/open/floor/plating,
/area/shuttle/escape)
"q" = (
/obj/machinery/sleeper,
/turf/open/floor/mineral/titanium/white,
/area/shuttle/escape)
"r" = (
/turf/open/floor/mineral/titanium,
/area/shuttle/escape)
"s" = (
/obj/structure/chair/comfy/shuttle{
	dir = 4
	},
/turf/open/floor/mineral/titanium/blue,
/area/shuttle/escape)
"t" = (
/obj/structure/table/reinforced,
/turf/open/floor/mineral/titanium,
/area/shuttle/escape)
"u" = (
/obj/structure/chair/comfy/brown{
	dir = 4
	},
/obj/machinery/light/small{
	dir = 1
	},
/turf/open/floor/mineral/titanium/yellow,
/area/shuttle/escape)
"v" = (
/obj/structure/window/reinforced{
	dir = 4
	},
/obj/structure/window/reinforced{
	dir = 1
	},
/obj/structure/table/reinforced,
/obj/item/radio,
/turf/open/floor/mineral/titanium/yellow,
/area/shuttle/escape)
"w" = (
/obj/machinery/door/airlock/public/glass{
	name = "Emergency Shuttle Infirmary"
	},
/turf/open/floor/mineral/titanium/white,
/area/shuttle/escape)
"x" = (
/obj/machinery/door/airlock/public/glass{
	name = "Emergency Shuttle Cockpit";
	req_access_txt = "19"
	},
/turf/open/floor/mineral/titanium/yellow,
/area/shuttle/escape)
"y" = (
/turf/open/floor/mineral/titanium/yellow,
/area/shuttle/escape)
"z" = (
/obj/machinery/computer/emergency_shuttle{
	dir = 8
	},
/obj/structure/window/reinforced{
	dir = 4
	},
/turf/open/floor/mineral/titanium/yellow,
/area/shuttle/escape)
"A" = (
/obj/structure/chair/comfy/brown{
	dir = 4
	},
/obj/machinery/light/small,
/turf/open/floor/mineral/titanium/yellow,
/area/shuttle/escape)
"B" = (
/obj/structure/table/reinforced,
/obj/structure/window/reinforced{
	dir = 4
	},
/obj/structure/window/reinforced,
/obj/item/storage/firstaid/regular,
/turf/open/floor/mineral/titanium/yellow,
/area/shuttle/escape)
"C" = (
/obj/structure/table/reinforced,
/obj/item/storage/firstaid/regular,
/obj/structure/window/reinforced,
/turf/open/floor/mineral/titanium/yellow,
/area/shuttle/escape)
"D" = (
/obj/machinery/light,
/obj/structure/chair/comfy/shuttle{
	dir = 4
	},
/turf/open/floor/mineral/titanium/blue,
/area/shuttle/escape)
"H" = (
/obj/structure/chair/comfy/shuttle{
	dir = 4
	},
/turf/open/floor/mineral/plastitanium/red/brig,
/area/shuttle/escape)
"J" = (
/turf/open/floor/mineral/plastitanium/red/brig,
/area/shuttle/escape)
"K" = (
/obj/machinery/door/airlock/public/glass{
	name = "Emergency Shuttle Brig";
	req_access_txt = "2"
	},
/turf/open/floor/mineral/plastitanium/red/brig,
/area/shuttle/escape)
"P" = (
/obj/structure/table/optable,
/turf/open/floor/mineral/titanium/white,
/area/shuttle/escape)
"Q" = (
/obj/machinery/light,
/turf/open/floor/mineral/titanium,
/area/shuttle/escape)
"R" = (
/obj/machinery/light/small,
/obj/structure/table,
/obj/item/storage/backpack/duffelbag/med/surgery,
/turf/open/floor/mineral/titanium/white,
/area/shuttle/escape)
"T" = (
/obj/structure/chair/comfy/shuttle{
	dir = 4
	},
/obj/machinery/light/small{
	dir = 1
	},
/turf/open/floor/mineral/plastitanium/red/brig,
/area/shuttle/escape)
"V" = (
/obj/machinery/light{
	dir = 1
	},
/turf/open/floor/mineral/titanium,
/area/shuttle/escape)
"W" = (
/obj/structure/shuttle/engine/propulsion{
	dir = 4
	},
/obj/structure/window/reinforced{
	dir = 1
	},
/turf/open/floor/plating,
/area/shuttle/escape)
"X" = (
/obj/structure/shuttle/engine/propulsion{
	dir = 4
	},
/obj/structure/window/reinforced,
/turf/open/floor/plating,
/area/shuttle/escape)
"Y" = (
/obj/structure/shuttle/engine/heater{
	dir = 8
	},
/obj/structure/window/reinforced,
/turf/open/floor/plating,
/area/shuttle/escape)

(1,1,1) = {"
a
d
b
b
b
d
b
b
b
d
a
"}
(2,1,1) = {"
W
d
p
p
p
d
p
p
p
d
X
"}
(3,1,1) = {"
c
d
q
n
P
d
H
H
H
d
Y
"}
(4,1,1) = {"
d
l
q
n
R
d
T
J
H
d
d
"}
(5,1,1) = {"
d
d
d
w
f
d
f
K
d
d
d
"}
(6,1,1) = {"
d
t
t
r
s
s
s
r
s
s
d
"}
(7,1,1) = {"
g
r
r
r
s
s
s
r
s
s
m
"}
(8,1,1) = {"
m
r
r
Q
d
m
d
V
s
s
m
"}
(9,1,1) = {"
g
r
r
r
r
r
r
r
s
s
m
"}
(10,1,1) = {"
m
r
r
s
s
s
s
r
r
r
m
"}
(11,1,1) = {"
d
d
r
s
s
s
s
r
r
d
d
"}
(12,1,1) = {"
m
h
r
r
r
r
r
r
r
h
m
"}
(13,1,1) = {"
d
e
s
s
s
r
s
s
s
D
d
"}
(14,1,1) = {"
m
s
s
s
s
r
s
s
s
s
m
"}
(15,1,1) = {"
o
r
r
r
r
r
s
s
s
s
m
"}
(16,1,1) = {"
m
r
r
s
s
r
s
s
s
s
m
"}
(17,1,1) = {"
g
r
r
r
i
r
i
r
r
r
d
"}
(18,1,1) = {"
d
d
d
m
d
x
f
m
d
d
d
"}
(19,1,1) = {"
a
a
m
j
k
y
k
C
m
a
a
"}
(20,1,1) = {"
a
a
d
d
u
k
A
d
d
a
a
"}
(21,1,1) = {"
a
a
a
m
v
z
B
m
a
a
a
"}
(22,1,1) = {"
a
a
a
d
m
m
m
d
a
a
a
"}
