//MAP CONVERTED BY dmm2tgm.py THIS HEADER COMMENT PREVENTS RECONVERSION, DO NOT REMOVE
"aa" = (
/turf/template_noop,
/area/template_noop)
"ab" = (
/turf/closed/wall/mineral/titanium,
/area/shuttle/escape)
"ac" = (
/obj/effect/spawner/structure/window/shuttle,
/turf/open/floor/plating,
/area/shuttle/escape)
"ad" = (
/obj/effect/spawner/structure/window/shuttle,
/turf/open/space/basic,
/area/shuttle/escape)
"ae" = (
/turf/closed/wall/mineral/titanium/nodiagonal,
/area/shuttle/escape)
"af" = (
/obj/structure/table/wood,
/obj/item/flashlight/lamp/green,
/turf/open/floor/carpet,
/area/shuttle/escape)
"ag" = (
/obj/structure/chair/comfy/brown{
	dir = 1
	},
/turf/open/floor/carpet,
/area/shuttle/escape)
"ah" = (
/obj/machinery/computer/emergency_shuttle,
/turf/open/floor/carpet,
/area/shuttle/escape)
"ai" = (
/obj/structure/table/wood,
/obj/item/storage/fancy/cigarettes/cigars/havana,
/obj/item/lighter{
	pixel_x = -4;
	pixel_y = 6
	},
/obj/item/reagent_containers/food/drinks/bottle/whiskey,
/obj/item/storage/box/drinkingglasses,
/turf/open/floor/carpet,
/area/shuttle/escape)
"ak" = (
/obj/structure/extinguisher_cabinet{
	pixel_y = 30
	},
/obj/machinery/light/small{
	dir = 1
	},
/turf/open/floor/plasteel/freezer,
/area/shuttle/escape)
"al" = (
/obj/machinery/computer/atmos_alert{
	dir = 4
	},
/turf/open/floor/carpet,
/area/shuttle/escape)
"am" = (
/obj/structure/chair/comfy/brown{
	dir = 8
	},
/turf/open/floor/carpet,
/area/shuttle/escape)
"an" = (
/turf/open/floor/carpet,
/area/shuttle/escape)
"ao" = (
/obj/structure/chair/comfy/brown{
	dir = 4
	},
/turf/open/floor/carpet,
/area/shuttle/escape)
"aq" = (
/obj/machinery/computer/crew{
	dir = 4
	},
/turf/open/floor/carpet,
/area/shuttle/escape)
"ar" = (
/obj/structure/extinguisher_cabinet{
	pixel_y = -30
	},
/obj/structure/chair/comfy/brown{
	dir = 8
	},
/turf/open/floor/carpet,
/area/shuttle/escape)
"as" = (
/obj/item/radio/intercom{
	name = "Station Intercom (General)";
	pixel_y = -29
	},
/turf/open/floor/carpet,
/area/shuttle/escape)
"at" = (
/obj/machinery/button/flasher{
	id = "cockpit_flasher";
	pixel_x = 6;
	pixel_y = -24
	},
/obj/machinery/light,
/turf/open/floor/carpet,
/area/shuttle/escape)
"au" = (
/obj/structure/table,
/obj/item/storage/backpack/duffelbag/med/surgery,
/turf/open/floor/mineral/titanium,
/area/shuttle/escape)
"av" = (
/obj/machinery/door/airlock/titanium{
	name = "Emergency Shuttle Airlock";
	req_access_txt = "2"
	},
/obj/structure/fans/tiny,
/turf/open/floor/mineral/plastitanium/red/brig,
/area/shuttle/escape)
"aw" = (
/obj/machinery/door/airlock/titanium{
	name = "Emergency Shuttle Airlock"
	},
/obj/docking_port/mobile/emergency{
	name = "The Emergency Escape Bar"
	},
/obj/effect/turf_decal/tile/bar,
/obj/effect/turf_decal/tile/bar{
	dir = 1
	},
/obj/structure/fans/tiny,
/turf/open/floor/plasteel,
/area/shuttle/escape)
"ax" = (
/obj/machinery/door/airlock/titanium{
	name = "Emergency Shuttle Airlock"
	},
/obj/effect/turf_decal/tile/bar,
/obj/effect/turf_decal/tile/bar{
	dir = 1
	},
/obj/structure/fans/tiny,
/turf/open/floor/plasteel,
/area/shuttle/escape)
"ay" = (
/obj/machinery/door/airlock/titanium{
	name = "Emergency Shuttle Airlock"
	},
/obj/structure/fans/tiny,
/turf/open/floor/plasteel/freezer,
/area/shuttle/escape)
"az" = (
/obj/machinery/door/airlock/public/glass{
	name = "Emergency Shuttle Cockpit";
	req_access_txt = "19"
	},
/turf/open/floor/carpet,
/area/shuttle/escape)
"aA" = (
/obj/machinery/status_display/evac,
/turf/closed/wall/mineral/titanium,
/area/shuttle/escape)
"aB" = (
/obj/machinery/computer/security{
	dir = 8
	},
/turf/open/floor/carpet,
/area/shuttle/escape)
"aC" = (
/obj/structure/chair/comfy/shuttle,
/turf/open/floor/mineral/plastitanium/red/brig,
/area/shuttle/escape)
"aD" = (
/obj/machinery/flasher{
	id = "cockpit_flasher";
	pixel_x = 6;
	pixel_y = 24
	},
/obj/item/kirbyplants{
	icon_state = "plant-21";
	pixel_x = -3;
	pixel_y = 3
	},
/obj/machinery/light{
	dir = 1
	},
/obj/effect/turf_decal/tile/bar,
/obj/effect/turf_decal/tile/bar{
	dir = 1
	},
/turf/open/floor/plasteel,
/area/shuttle/escape)
"aE" = (
/obj/effect/turf_decal/tile/bar,
/obj/effect/turf_decal/tile/bar{
	dir = 1
	},
/turf/open/floor/plasteel,
/area/shuttle/escape)
"aF" = (
/obj/structure/musician/piano{
	icon_state = "piano"
	},
/turf/open/floor/plasteel/grimy,
/area/shuttle/escape)
"aG" = (
/obj/machinery/computer/communications{
	dir = 8
	},
/turf/open/floor/carpet,
/area/shuttle/escape)
"aH" = (
/obj/machinery/flasher{
	id = "shuttle_flasher";
	pixel_x = -24;
	pixel_y = 6
	},
/obj/machinery/button/flasher{
	id = "shuttle_flasher";
	pixel_x = -24;
	pixel_y = -6
	},
/obj/machinery/light/small{
	brightness = 3;
	dir = 8
	},
/turf/open/floor/mineral/plastitanium/red/brig,
/area/shuttle/escape)
"aI" = (
/turf/open/floor/mineral/plastitanium/red/brig,
/area/shuttle/escape)
"aJ" = (
/obj/machinery/door/airlock/public/glass{
	name = "Emergency Shuttle Brig";
	req_access_txt = "2"
	},
/obj/effect/turf_decal/tile/bar,
/obj/effect/turf_decal/tile/bar{
	dir = 1
	},
/turf/open/floor/plasteel,
/area/shuttle/escape)
"aK" = (
/obj/structure/chair/stool{
	can_buckle = 1
	},
/turf/open/floor/plasteel/grimy,
/area/shuttle/escape)
"aL" = (
/obj/structure/extinguisher_cabinet{
	pixel_y = -30
	},
/turf/open/floor/mineral/plastitanium/red/brig,
/area/shuttle/escape)
"aM" = (
/obj/structure/chair/comfy/shuttle{
	dir = 1
	},
/turf/open/floor/mineral/plastitanium/red/brig,
/area/shuttle/escape)
"aN" = (
/obj/structure/chair/stool/bar{
	can_buckle = 1;
	name = "buckleable bar stool"
	},
/obj/effect/turf_decal/tile/bar,
/obj/effect/turf_decal/tile/bar{
	dir = 1
	},
/turf/open/floor/plasteel,
/area/shuttle/escape)
"aO" = (
/obj/structure/table/wood/bar{
	boot_dir = 9
	},
/obj/effect/turf_decal/tile/bar,
/obj/effect/turf_decal/tile/bar{
	dir = 1
	},
/turf/open/floor/plasteel,
/area/shuttle/escape)
"aP" = (
/obj/structure/table/wood/bar,
/obj/effect/turf_decal/tile/bar,
/obj/effect/turf_decal/tile/bar{
	dir = 1
	},
/turf/open/floor/plasteel,
/area/shuttle/escape)
"aQ" = (
/obj/machinery/light/small{
	dir = 4
	},
/turf/open/floor/plasteel/grimy,
/area/shuttle/escape)
"aR" = (
/obj/structure/table/wood/bar{
	boot_dir = 8
	},
/obj/effect/turf_decal/tile/bar,
/obj/effect/turf_decal/tile/bar{
	dir = 1
	},
/turf/open/floor/plasteel,
/area/shuttle/escape)
"aS" = (
/obj/structure/table/wood/bar,
/obj/item/instrument/guitar,
/obj/effect/turf_decal/tile/bar,
/obj/effect/turf_decal/tile/bar{
	dir = 1
	},
/turf/open/floor/plasteel,
/area/shuttle/escape)
"aT" = (
/obj/structure/extinguisher_cabinet{
	pixel_x = 27
	},
/obj/structure/table,
/obj/item/storage/box/drinkingglasses,
/obj/item/reagent_containers/food/drinks/bottle/lizardwine,
/obj/effect/turf_decal/tile/bar,
/obj/effect/turf_decal/tile/bar{
	dir = 1
	},
/turf/open/floor/plasteel,
/area/shuttle/escape)
"aU" = (
/obj/effect/turf_decal/tile/bar,
/obj/effect/turf_decal/tile/bar{
	dir = 1
	},
/mob/living/simple_animal/hostile/alien/maid/barmaid,
/turf/open/floor/plasteel,
/area/shuttle/escape)
"aV" = (
/obj/structure/table,
/obj/machinery/chem_dispenser/drinks/beer{
	dir = 8
	},
/obj/effect/turf_decal/tile/bar,
/obj/effect/turf_decal/tile/bar{
	dir = 1
	},
/turf/open/floor/plasteel,
/area/shuttle/escape)
"aW" = (
/obj/structure/chair/wood/normal,
/turf/open/floor/plasteel/grimy,
/area/shuttle/escape)
"aX" = (
/obj/machinery/light{
	dir = 4
	},
/obj/effect/turf_decal/tile/bar,
/obj/effect/turf_decal/tile/bar{
	dir = 1
	},
/mob/living/simple_animal/drone/snowflake/bardrone,
/turf/open/floor/plasteel,
/area/shuttle/escape)
"aY" = (
/obj/machinery/vending/boozeomat,
/turf/closed/wall/mineral/titanium,
/area/shuttle/escape)
"aZ" = (
/obj/structure/chair/wood/normal{
	dir = 4
	},
/turf/open/floor/plasteel/grimy,
/area/shuttle/escape)
"ba" = (
/obj/structure/table/wood/bar,
/obj/effect/spawner/lootdrop/gambling,
/turf/open/floor/plasteel/grimy,
/area/shuttle/escape)
"bb" = (
/obj/structure/table,
/obj/machinery/chem_dispenser/drinks{
	dir = 8
	},
/obj/effect/turf_decal/tile/bar,
/obj/effect/turf_decal/tile/bar{
	dir = 1
	},
/turf/open/floor/plasteel,
/area/shuttle/escape)
"bc" = (
/obj/item/kirbyplants{
	icon_state = "plant-21";
	pixel_x = -3;
	pixel_y = 3
	},
/turf/open/floor/plasteel/grimy,
/area/shuttle/escape)
"bd" = (
/obj/structure/table/wood/bar{
	boot_dir = 10
	},
/obj/effect/turf_decal/tile/bar,
/obj/effect/turf_decal/tile/bar{
	dir = 1
	},
/turf/open/floor/plasteel,
/area/shuttle/escape)
"be" = (
/obj/structure/table/wood/bar{
	boot_dir = 2
	},
/obj/effect/turf_decal/tile/bar,
/obj/effect/turf_decal/tile/bar{
	dir = 1
	},
/turf/open/floor/plasteel,
/area/shuttle/escape)
"bf" = (
/obj/structure/table,
/obj/item/storage/box/drinkingglasses,
/obj/item/reagent_containers/food/drinks/shaker,
/obj/item/storage/fancy/cigarettes/cigars/havana,
/obj/effect/turf_decal/tile/bar,
/obj/effect/turf_decal/tile/bar{
	dir = 1
	},
/turf/open/floor/plasteel,
/area/shuttle/escape)
"bg" = (
/obj/item/kirbyplants{
	icon_state = "plant-10"
	},
/obj/effect/turf_decal/tile/bar,
/obj/effect/turf_decal/tile/bar{
	dir = 1
	},
/turf/open/floor/plasteel,
/area/shuttle/escape)
"bh" = (
/obj/machinery/vending/cigarette,
/obj/effect/turf_decal/tile/bar,
/obj/effect/turf_decal/tile/bar{
	dir = 1
	},
/turf/open/floor/plasteel,
/area/shuttle/escape)
"bi" = (
/turf/open/floor/mineral/titanium,
/area/shuttle/escape)
"bj" = (
/obj/effect/spawner/structure/window/shuttle,
/turf/open/floor/plasteel/freezer,
/area/shuttle/escape)
"bk" = (
/obj/machinery/sleeper{
	dir = 8
	},
/turf/open/floor/mineral/titanium,
/area/shuttle/escape)
"bl" = (
/obj/machinery/sleeper{
	dir = 8
	},
/obj/machinery/light/small{
	dir = 4
	},
/turf/open/floor/mineral/titanium,
/area/shuttle/escape)
"bm" = (
/obj/machinery/door/airlock{
	name = "Unisex Restrooms"
	},
/turf/open/floor/plasteel/freezer,
/area/shuttle/escape)
"bn" = (
/obj/effect/spawner/structure/window/shuttle,
/obj/structure/sign/departments/medbay/alt,
/turf/closed/wall/mineral/titanium,
/area/shuttle/escape)
"bo" = (
/obj/structure/table,
/obj/item/storage/firstaid/fire,
/obj/item/storage/firstaid/brute{
	pixel_x = 4;
	pixel_y = 4
	},
/turf/open/floor/mineral/titanium,
/area/shuttle/escape)
"bp" = (
/turf/open/floor/plasteel/freezer,
/area/shuttle/escape)
"bq" = (
/obj/machinery/door/airlock/medical/glass{
	name = "Medbay"
	},
/turf/open/floor/mineral/titanium,
/area/shuttle/escape)
"br" = (
/obj/machinery/computer/card,
/turf/open/floor/carpet,
/area/shuttle/escape)
"bs" = (
/obj/machinery/door/airlock{
	name = "Unit 1"
	},
/turf/open/floor/plasteel/freezer,
/area/shuttle/escape)
"bu" = (
/obj/machinery/door/airlock{
	name = "Unit 2"
	},
/turf/open/floor/plasteel/freezer,
/area/shuttle/escape)
"bv" = (
/obj/machinery/door/airlock{
	name = "Unit B"
	},
/turf/open/floor/plasteel/freezer,
/area/shuttle/escape)
"bw" = (
/obj/structure/table/optable,
/obj/machinery/light/small{
	brightness = 3;
	dir = 8
	},
/turf/open/floor/mineral/titanium,
/area/shuttle/escape)
"bx" = (
/obj/structure/toilet{
	dir = 4
	},
/obj/machinery/light/small{
	dir = 4
	},
/turf/open/floor/plasteel/freezer,
/area/shuttle/escape)
"by" = (
/obj/machinery/recharge_station,
/obj/machinery/light/small{
	dir = 4
	},
/turf/open/floor/plasteel/freezer,
/area/shuttle/escape)
"bA" = (
/obj/effect/turf_decal/tile/bar{
	dir = 1
	},
/obj/effect/turf_decal/tile/bar,
/turf/open/floor/plasteel,
/area/shuttle/escape)
"bC" = (
/obj/structure/window/reinforced{
	dir = 1
	},
/obj/structure/shuttle/engine/heater,
/turf/open/floor/plating/airless,
/area/shuttle/escape)
"bE" = (
/obj/structure/shuttle/engine/propulsion,
/turf/open/floor/plating/airless,
/area/shuttle/escape)
"bG" = (
/obj/item/kirbyplants{
	icon_state = "plant-21";
	pixel_x = -3;
	pixel_y = 3
	},
/obj/effect/turf_decal/tile/bar,
/obj/effect/turf_decal/tile/bar{
	dir = 1
	},
/turf/open/floor/plasteel,
/area/shuttle/escape)
"bH" = (
/turf/open/floor/plasteel/grimy,
/area/shuttle/escape)
"bJ" = (
/obj/structure/table/wood/bar,
/obj/item/storage/fancy/donut_box,
/turf/open/floor/plasteel/grimy,
/area/shuttle/escape)
"bK" = (
/obj/structure/chair/wood/normal{
	dir = 8
	},
/turf/open/floor/plasteel/grimy,
/area/shuttle/escape)
"bL" = (
/obj/structure/table/wood/bar,
/turf/open/floor/plasteel/grimy,
/area/shuttle/escape)
"bM" = (
/obj/structure/chair/comfy/brown{
	dir = 8
	},
/turf/open/floor/plasteel/grimy,
/area/shuttle/escape)
"bO" = (
/obj/structure/table/wood/bar,
/obj/item/folder/red,
/turf/open/floor/plasteel/grimy,
/area/shuttle/escape)
"bP" = (
/obj/structure/table/wood/bar,
/obj/item/toy/cards/deck/cas,
/obj/item/toy/cards/deck/cas/black{
	pixel_y = 6
	},
/turf/open/floor/plasteel/grimy,
/area/shuttle/escape)
"bQ" = (
/obj/structure/chair/wood/normal{
	dir = 1
	},
/turf/open/floor/plasteel/grimy,
/area/shuttle/escape)
"bR" = (
/obj/structure/extinguisher_cabinet{
	pixel_y = -30
	},
/obj/effect/turf_decal/tile/bar,
/obj/effect/turf_decal/tile/bar{
	dir = 1
	},
/turf/open/floor/plasteel,
/area/shuttle/escape)
"bS" = (
/obj/structure/table,
/obj/item/storage/firstaid/regular,
/obj/item/storage/firstaid/toxin{
	pixel_x = 4;
	pixel_y = 4
	},
/turf/open/floor/mineral/titanium,
/area/shuttle/escape)
"bV" = (
/obj/structure/table/wood/bar{
	boot_dir = 8
	},
/obj/effect/fun_balloon/sentience/emergency_shuttle{
	group_name = "bar staff on the Emergency Escape Bar"
	},
/obj/effect/turf_decal/tile/bar,
/obj/effect/turf_decal/tile/bar{
	dir = 1
	},
/turf/open/floor/plasteel,
/area/shuttle/escape)
"bX" = (
/obj/machinery/light{
	dir = 8
	},
/obj/effect/turf_decal/tile/bar,
/obj/effect/turf_decal/tile/bar{
	dir = 1
	},
/turf/open/floor/plasteel,
/area/shuttle/escape)
"bY" = (
/obj/machinery/light/small{
	dir = 1
	},
/obj/effect/turf_decal/tile/bar,
/obj/effect/turf_decal/tile/bar{
	dir = 1
	},
/turf/open/floor/plasteel,
/area/shuttle/escape)
"bZ" = (
/obj/machinery/light/small,
/obj/effect/turf_decal/tile/bar,
/obj/effect/turf_decal/tile/bar{
	dir = 1
	},
/turf/open/floor/plasteel,
/area/shuttle/escape)
"ca" = (
/obj/machinery/light,
/obj/effect/turf_decal/tile/bar,
/obj/effect/turf_decal/tile/bar{
	dir = 1
	},
/turf/open/floor/plasteel,
/area/shuttle/escape)

(1,1,1) = {"
aa
aa
aa
aa
ab
ab
ab
av
ab
aw
ab
ac
ac
ac
ab
ax
ab
ay
ab
ab
ab
aa
"}
(2,1,1) = {"
aa
ab
ab
ab
ab
aC
aH
aL
ab
bY
bA
bA
bA
bA
bA
bZ
ab
bp
bs
bx
ab
ab
"}
(3,1,1) = {"
ab
ae
al
aq
ab
aC
aI
aM
ab
aE
bH
aZ
bc
aZ
bH
bR
ab
bp
ab
ab
bC
bE
"}
(4,1,1) = {"
ac
af
am
ar
ab
aC
aI
aM
ab
aE
aW
ba
bL
bO
bQ
aE
ab
ak
bu
bx
bC
bE
"}
(5,1,1) = {"
ac
ag
an
as
ab
ac
aJ
ac
ae
aE
aW
bJ
bM
bP
bQ
aE
aA
bp
ab
ab
bC
bE
"}
(6,1,1) = {"
ac
ah
an
at
ab
aD
aE
aE
bX
aE
bH
bK
bH
bK
bH
aE
bm
bp
bv
by
bC
bE
"}
(7,1,1) = {"
ac
br
an
an
az
bA
bA
bA
bA
bA
bA
bA
bA
bA
bA
bA
ae
ae
ab
ab
bC
bE
"}
(8,1,1) = {"
ad
ag
an
an
ab
aE
aE
aN
aN
aN
aN
aN
aN
aN
aE
ca
ae
bw
bi
au
bC
bE
"}
(9,1,1) = {"
ac
ai
ao
ao
aA
bG
aE
aO
aR
bV
aR
aR
aR
bd
aN
aE
bn
bi
bi
bi
bC
bE
"}
(10,1,1) = {"
ab
ae
aB
aG
ab
aF
bH
aP
aE
aU
aX
aE
aE
be
aE
aE
bq
bi
bi
bS
bC
bE
"}
(11,1,1) = {"
aa
ab
ab
ab
ab
aK
aQ
aS
aT
aV
aY
bb
bf
be
bg
bh
bj
bk
bl
bo
ab
ab
"}
(12,1,1) = {"
aa
aa
aa
aa
ab
ac
ab
ac
ab
ab
ab
ac
ac
ac
ab
ab
ab
ac
ab
ac
ab
aa
"}
