//MAP CONVERTED BY dmm2tgm.py THIS HEADER COMMENT PREVENTS RECONVERSION, DO NOT REMOVE
"a" = (
/turf/template_noop,
/area/template_noop)
"b" = (
/obj/structure/shuttle/engine/propulsion{
	dir = 4
	},
/turf/open/floor/plating,
/area/shuttle/escape)
"c" = (
/obj/structure/shuttle/engine/heater{
	dir = 8
	},
/obj/structure/window/reinforced{
	dir = 1
	},
/turf/open/floor/plating,
/area/shuttle/escape)
"d" = (
/turf/closed/wall/mineral/titanium,
/area/shuttle/escape)
"e" = (
/obj/structure/chair/comfy/shuttle{
	dir = 4
	},
/obj/machinery/light{
	dir = 1
	},
/turf/open/floor/mineral/titanium/blue,
/area/shuttle/escape)
"f" = (
/obj/machinery/status_display/evac,
/turf/closed/wall/mineral/titanium,
/area/shuttle/escape)
"g" = (
/obj/machinery/door/airlock/titanium{
	name = "Emergency Shuttle Airlock"
	},
/obj/structure/fans/tiny,
/turf/open/floor/plating,
/area/shuttle/escape)
"h" = (
/obj/structure/table/reinforced,
/turf/open/floor/mineral/titanium/blue,
/area/shuttle/escape)
"i" = (
/obj/machinery/light{
	dir = 4
	},
/turf/open/floor/mineral/titanium,
/area/shuttle/escape)
"j" = (
/obj/machinery/light{
	dir = 4
	},
/obj/structure/chair/comfy/shuttle{
	dir = 4
	},
/turf/open/floor/mineral/titanium/blue,
/area/shuttle/escape)
"k" = (
/obj/structure/chair/comfy/shuttle{
	dir = 4
	},
/obj/machinery/light,
/turf/open/floor/mineral/titanium/blue,
/area/shuttle/escape)
"l" = (
/obj/machinery/vending/wallmed,
/turf/closed/wall/mineral/titanium,
/area/shuttle/escape)
"m" = (
/obj/effect/spawner/structure/window/shuttle,
/turf/open/floor/plating,
/area/shuttle/escape)
"n" = (
/turf/open/floor/mineral/titanium/white,
/area/shuttle/escape)
"o" = (
/obj/machinery/door/airlock/titanium{
	name = "Emergency Shuttle Airlock"
	},
/obj/structure/fans/tiny,
/obj/docking_port/mobile/emergency{
	dheight = 0;
	dir = 2;
	dwidth = 9;
	name = "NES Classic";
	width = 22
	},
/turf/open/floor/plating,
/area/shuttle/escape)
"p" = (
/obj/structure/shuttle/engine/heater{
	dir = 8
	},
/obj/structure/window/reinforced{
	dir = 4
	},
/turf/open/floor/plating,
/area/shuttle/escape)
"q" = (
/obj/machinery/sleeper,
/turf/open/floor/mineral/titanium/white,
/area/shuttle/escape)
"r" = (
/turf/open/floor/mineral/titanium,
/area/shuttle/escape)
"s" = (
/obj/structure/chair/comfy/shuttle{
	dir = 4
	},
/turf/open/floor/mineral/titanium/blue,
/area/shuttle/escape)
"t" = (
/obj/structure/table/reinforced,
/turf/open/floor/mineral/titanium,
/area/shuttle/escape)
"v" = (
/obj/structure/table/reinforced,
/obj/item/storage/toolbox/emergency,
/obj/structure/window/reinforced{
	dir = 1
	},
/turf/open/floor/mineral/plastitanium,
/area/shuttle/escape)
"w" = (
/obj/machinery/door/airlock/public/glass{
	name = "Emergency Shuttle Infirmary"
	},
/turf/open/floor/mineral/titanium/white,
/area/shuttle/escape)
"x" = (
/obj/structure/chair/comfy/brown{
	dir = 4
	},
/turf/open/floor/mineral/plastitanium,
/area/shuttle/escape)
"y" = (
/obj/structure/chair/comfy/brown{
	dir = 4
	},
/obj/machinery/light/small{
	dir = 1
	},
/turf/open/floor/mineral/plastitanium,
/area/shuttle/escape)
"z" = (
/obj/structure/window/reinforced{
	dir = 4
	},
/obj/structure/window/reinforced{
	dir = 1
	},
/obj/structure/table/reinforced,
/obj/item/radio,
/turf/open/floor/mineral/plastitanium,
/area/shuttle/escape)
"A" = (
/obj/machinery/door/airlock/public/glass{
	name = "Emergency Shuttle Cockpit";
	req_access_txt = "19"
	},
/turf/open/floor/mineral/plastitanium,
/area/shuttle/escape)
"B" = (
/turf/open/floor/mineral/plastitanium,
/area/shuttle/escape)
"C" = (
/obj/machinery/computer/emergency_shuttle{
	dir = 8
	},
/obj/structure/window/reinforced{
	dir = 4
	},
/turf/open/floor/mineral/plastitanium,
/area/shuttle/escape)
"D" = (
/obj/structure/chair/comfy/brown{
	dir = 4
	},
/obj/machinery/light/small,
/turf/open/floor/mineral/plastitanium,
/area/shuttle/escape)
"E" = (
/obj/structure/table/reinforced,
/obj/structure/window/reinforced{
	dir = 4
	},
/obj/structure/window/reinforced,
/obj/item/storage/firstaid/regular,
/turf/open/floor/mineral/plastitanium,
/area/shuttle/escape)
"F" = (
/obj/structure/table/reinforced,
/obj/item/storage/firstaid/regular,
/obj/structure/window/reinforced,
/turf/open/floor/mineral/plastitanium,
/area/shuttle/escape)
"H" = (
/obj/structure/chair/comfy/shuttle{
	dir = 4
	},
/turf/open/floor/mineral/plastitanium/red/brig,
/area/shuttle/escape)
"J" = (
/turf/open/floor/mineral/plastitanium/red/brig,
/area/shuttle/escape)
"K" = (
/obj/machinery/door/airlock/public/glass{
	name = "Emergency Shuttle Brig";
	req_access_txt = "2"
	},
/turf/open/floor/mineral/plastitanium/red/brig,
/area/shuttle/escape)
"P" = (
/obj/structure/table/optable,
/turf/open/floor/mineral/titanium/white,
/area/shuttle/escape)
"Q" = (
/obj/machinery/light,
/turf/open/floor/mineral/titanium,
/area/shuttle/escape)
"R" = (
/obj/machinery/light/small,
/obj/structure/table,
/obj/item/storage/backpack/duffelbag/med/surgery,
/turf/open/floor/mineral/titanium/white,
/area/shuttle/escape)
"T" = (
/obj/structure/chair/comfy/shuttle{
	dir = 4
	},
/obj/machinery/light/small{
	dir = 1
	},
/turf/open/floor/mineral/plastitanium/red/brig,
/area/shuttle/escape)
"V" = (
/obj/machinery/light{
	dir = 1
	},
/turf/open/floor/mineral/titanium,
/area/shuttle/escape)
"W" = (
/obj/structure/shuttle/engine/propulsion{
	dir = 4
	},
/obj/structure/window/reinforced{
	dir = 1
	},
/turf/open/floor/plating,
/area/shuttle/escape)
"X" = (
/obj/structure/shuttle/engine/propulsion{
	dir = 4
	},
/obj/structure/window/reinforced,
/turf/open/floor/plating,
/area/shuttle/escape)
"Y" = (
/obj/structure/shuttle/engine/heater{
	dir = 8
	},
/obj/structure/window/reinforced,
/turf/open/floor/plating,
/area/shuttle/escape)

(1,1,1) = {"
a
d
b
b
b
d
b
b
b
d
a
"}
(2,1,1) = {"
W
d
p
p
p
d
p
p
p
d
X
"}
(3,1,1) = {"
c
d
q
n
P
d
H
H
H
d
Y
"}
(4,1,1) = {"
d
l
q
n
R
d
T
J
H
d
d
"}
(5,1,1) = {"
d
d
d
w
f
d
f
K
d
d
d
"}
(6,1,1) = {"
a
d
t
r
s
s
s
r
s
d
a
"}
(7,1,1) = {"
a
g
r
r
s
s
s
r
s
m
a
"}
(8,1,1) = {"
a
m
r
Q
d
m
d
V
s
m
a
"}
(9,1,1) = {"
a
g
r
r
r
r
r
r
s
m
a
"}
(10,1,1) = {"
a
m
s
s
s
r
s
r
s
m
a
"}
(11,1,1) = {"
d
d
s
s
s
r
s
r
s
d
d
"}
(12,1,1) = {"
m
h
r
r
r
r
r
r
r
h
m
"}
(13,1,1) = {"
d
d
e
s
s
r
s
s
k
d
d
"}
(14,1,1) = {"
a
m
s
s
s
r
s
s
s
m
a
"}
(15,1,1) = {"
a
o
r
r
r
r
s
s
s
m
a
"}
(16,1,1) = {"
a
m
r
s
s
r
s
s
s
m
a
"}
(17,1,1) = {"
a
g
r
r
i
r
j
s
s
d
a
"}
(18,1,1) = {"
a
d
d
m
d
A
f
m
d
d
a
"}
(19,1,1) = {"
a
a
m
v
x
B
x
F
m
a
a
"}
(20,1,1) = {"
a
a
d
d
y
x
D
d
d
a
a
"}
(21,1,1) = {"
a
a
a
m
z
C
E
m
a
a
a
"}
(22,1,1) = {"
a
a
a
d
m
m
m
d
a
a
a
"}
