//MAP CONVERTED BY dmm2tgm.py THIS HEADER COMMENT PREVENTS RECONVERSION, DO NOT REMOVE
"aa" = (
/turf/template_noop,
/area/template_noop)
"ab" = (
/turf/closed/wall/mineral/titanium,
/area/shuttle/escape)
"ac" = (
/obj/effect/spawner/structure/window/shuttle,
/turf/open/floor/plating,
/area/shuttle/escape)
"ad" = (
/obj/structure/table/reinforced,
/obj/item/storage/toolbox/mechanical,
/obj/item/radio,
/turf/open/floor/plasteel/dark,
/area/shuttle/escape)
"ae" = (
/obj/machinery/computer/communications,
/obj/effect/turf_decal/bot,
/turf/open/floor/plasteel/dark,
/area/shuttle/escape)
"af" = (
/obj/machinery/computer/emergency_shuttle,
/obj/effect/turf_decal/bot,
/turf/open/floor/plasteel/dark,
/area/shuttle/escape)
"ag" = (
/obj/machinery/computer/crew,
/obj/effect/turf_decal/bot,
/turf/open/floor/plasteel/dark,
/area/shuttle/escape)
"ah" = (
/obj/structure/table/reinforced,
/obj/item/storage/firstaid/o2{
	pixel_x = 4;
	pixel_y = 4
	},
/obj/item/storage/firstaid/regular,
/obj/item/crowbar,
/turf/open/floor/plasteel/dark,
/area/shuttle/escape)
"ai" = (
/obj/structure/sign/nanotrasen,
/turf/closed/wall/mineral/titanium,
/area/shuttle/escape)
"aj" = (
/obj/structure/table/reinforced,
/obj/machinery/recharger,
/turf/open/floor/plasteel/dark,
/area/shuttle/escape)
"ak" = (
/obj/effect/turf_decal/tile/neutral{
	dir = 1
	},
/obj/effect/turf_decal/tile/neutral{
	dir = 4
	},
/obj/effect/turf_decal/tile/neutral{
	dir = 8
	},
/turf/open/floor/mineral/titanium/blue,
/area/shuttle/escape)
"al" = (
/obj/structure/chair/comfy/shuttle,
/obj/effect/turf_decal/tile/neutral{
	dir = 4
	},
/obj/effect/turf_decal/tile/neutral{
	dir = 1
	},
/turf/open/floor/mineral/titanium/blue,
/area/shuttle/escape)
"am" = (
/obj/effect/turf_decal/tile/neutral{
	dir = 4
	},
/obj/effect/turf_decal/tile/neutral{
	dir = 1
	},
/obj/effect/turf_decal/tile/neutral,
/turf/open/floor/mineral/titanium/blue,
/area/shuttle/escape)
"an" = (
/obj/structure/table/reinforced,
/obj/item/clipboard,
/obj/item/restraints/handcuffs,
/obj/item/tank/internals/emergency_oxygen/engi,
/obj/item/tank/internals/emergency_oxygen/engi,
/obj/item/assembly/flash/handheld,
/turf/open/floor/plasteel/dark,
/area/shuttle/escape)
"ao" = (
/obj/effect/turf_decal/stripes/line{
	dir = 1
	},
/obj/machinery/door/airlock/shuttle{
	name = "External Shuttle Airlock"
	},
/obj/effect/mapping_helpers/airlock/cyclelink_helper,
/obj/structure/fans/tiny,
/turf/open/floor/plasteel/dark,
/area/shuttle/escape)
"ap" = (
/obj/structure/table,
/obj/item/crowbar/red,
/obj/item/storage/lockbox/loyalty,
/turf/open/floor/mineral/plastitanium/red/brig,
/area/shuttle/escape)
"aq" = (
/obj/structure/chair/comfy/shuttle,
/turf/open/floor/mineral/plastitanium/red/brig,
/area/shuttle/escape)
"ar" = (
/obj/structure/table,
/obj/machinery/recharger,
/turf/open/floor/mineral/plastitanium/red/brig,
/area/shuttle/escape)
"as" = (
/turf/closed/wall/mineral/titanium/nodiagonal,
/area/shuttle/escape)
"at" = (
/obj/structure/chair/comfy/shuttle{
	dir = 4
	},
/obj/machinery/light{
	dir = 8
	},
/obj/machinery/keycard_auth{
	pixel_x = -24
	},
/obj/effect/turf_decal/tile/neutral{
	dir = 1
	},
/obj/effect/turf_decal/tile/neutral{
	dir = 8
	},
/turf/open/floor/mineral/titanium/blue,
/area/shuttle/escape)
"au" = (
/obj/structure/table/reinforced,
/obj/item/folder/red{
	pixel_x = 4;
	pixel_y = 4
	},
/obj/item/folder/blue,
/turf/open/floor/mineral/titanium/blue,
/area/shuttle/escape)
"av" = (
/obj/structure/chair/comfy/shuttle{
	dir = 8
	},
/obj/machinery/light{
	dir = 4
	},
/obj/machinery/keycard_auth{
	pixel_x = 24
	},
/obj/effect/turf_decal/tile/neutral,
/obj/effect/turf_decal/tile/neutral{
	dir = 4
	},
/turf/open/floor/mineral/titanium/blue,
/area/shuttle/escape)
"aw" = (
/obj/machinery/light/small{
	dir = 8
	},
/obj/structure/closet/emcloset/anchored,
/obj/effect/turf_decal/bot,
/turf/open/floor/plasteel/dark,
/area/shuttle/escape)
"ax" = (
/obj/structure/sign/warning/vacuum/external{
	pixel_y = 32
	},
/obj/effect/turf_decal/stripes/end{
	dir = 4
	},
/turf/open/floor/mineral/titanium/yellow,
/area/shuttle/escape)
"ay" = (
/obj/structure/chair/comfy/shuttle{
	dir = 4
	},
/turf/open/floor/mineral/plastitanium/red/brig,
/area/shuttle/escape)
"az" = (
/turf/open/floor/mineral/plastitanium/red/brig,
/area/shuttle/escape)
"aA" = (
/obj/structure/chair/comfy/shuttle{
	dir = 8
	},
/obj/machinery/light{
	dir = 1
	},
/turf/open/floor/mineral/plastitanium/red/brig,
/area/shuttle/escape)
"aB" = (
/obj/structure/chair/comfy/shuttle{
	dir = 4
	},
/obj/effect/turf_decal/tile/neutral{
	dir = 1
	},
/obj/effect/turf_decal/tile/neutral{
	dir = 8
	},
/turf/open/floor/mineral/titanium/blue,
/area/shuttle/escape)
"aC" = (
/obj/structure/table/reinforced,
/obj/item/storage/fancy/donut_box,
/turf/open/floor/mineral/titanium/blue,
/area/shuttle/escape)
"aD" = (
/obj/machinery/status_display,
/turf/closed/wall/mineral/titanium,
/area/shuttle/escape)
"aE" = (
/obj/structure/chair/comfy/shuttle{
	dir = 8
	},
/obj/effect/turf_decal/tile/neutral,
/obj/effect/turf_decal/tile/neutral{
	dir = 4
	},
/turf/open/floor/mineral/titanium/blue,
/area/shuttle/escape)
"aF" = (
/obj/machinery/door/airlock/shuttle{
	name = "External Shuttle Airlock"
	},
/obj/effect/mapping_helpers/airlock/cyclelink_helper{
	dir = 1
	},
/obj/structure/fans/tiny,
/turf/open/floor/plasteel/dark,
/area/shuttle/escape)
"aG" = (
/obj/machinery/door/airlock/security/glass{
	name = "Holding Area";
	req_one_access_txt = "19"
	},
/turf/open/floor/plasteel/dark,
/area/shuttle/escape)
"aH" = (
/obj/effect/turf_decal/tile/neutral{
	dir = 1
	},
/obj/effect/turf_decal/tile/neutral{
	dir = 8
	},
/turf/open/floor/mineral/titanium/blue,
/area/shuttle/escape)
"aI" = (
/obj/structure/chair/comfy/shuttle{
	dir = 1
	},
/turf/open/floor/mineral/titanium/blue,
/area/shuttle/escape)
"aJ" = (
/obj/effect/turf_decal/tile/neutral,
/obj/effect/turf_decal/tile/neutral{
	dir = 4
	},
/turf/open/floor/mineral/titanium/blue,
/area/shuttle/escape)
"aK" = (
/obj/machinery/door/airlock/command{
	name = "Shuttle Control";
	req_one_access_txt = "19"
	},
/turf/open/floor/plasteel/dark,
/area/shuttle/escape)
"aL" = (
/obj/effect/turf_decal/delivery,
/obj/effect/turf_decal/stripes/line,
/obj/effect/turf_decal/stripes/line{
	dir = 1
	},
/turf/open/floor/plasteel/dark,
/area/shuttle/escape)
"aM" = (
/obj/effect/turf_decal/stripes/corner{
	dir = 1
	},
/obj/effect/turf_decal/stripes/line{
	dir = 1
	},
/turf/open/floor/mineral/titanium/yellow,
/area/shuttle/escape)
"aN" = (
/obj/effect/turf_decal/stripes/line{
	dir = 1
	},
/turf/open/floor/mineral/titanium/yellow,
/area/shuttle/escape)
"aO" = (
/obj/item/clothing/suit/hazardvest{
	desc = "A high-visibility lifejacket complete with whistle and slot for oxygen tanks.";
	name = "emergency lifejacket"
	},
/obj/item/clothing/suit/hazardvest{
	desc = "A high-visibility lifejacket complete with whistle and slot for oxygen tanks.";
	name = "emergency lifejacket"
	},
/obj/item/tank/internals/emergency_oxygen{
	pixel_x = 3
	},
/obj/item/tank/internals/emergency_oxygen{
	pixel_x = 3
	},
/obj/item/clothing/mask/breath{
	pixel_x = -3;
	pixel_y = -3
	},
/obj/item/clothing/mask/breath{
	pixel_x = -3;
	pixel_y = -3
	},
/obj/item/clothing/head/hardhat/orange{
	name = "protective hat";
	pixel_y = 9
	},
/obj/item/clothing/head/hardhat/orange{
	name = "protective hat";
	pixel_y = 9
	},
/obj/structure/closet/crate/internals,
/obj/effect/turf_decal/bot,
/obj/effect/turf_decal/stripes/corner{
	dir = 4
	},
/turf/open/floor/plasteel/dark,
/area/shuttle/escape)
"aP" = (
/obj/structure/chair/comfy/shuttle{
	dir = 4
	},
/obj/machinery/light{
	dir = 8
	},
/turf/open/floor/mineral/plastitanium/red/brig,
/area/shuttle/escape)
"aQ" = (
/obj/structure/chair/comfy/shuttle{
	dir = 8
	},
/turf/open/floor/mineral/plastitanium/red/brig,
/area/shuttle/escape)
"aR" = (
/obj/effect/turf_decal/tile/neutral,
/obj/effect/turf_decal/tile/neutral{
	dir = 8
	},
/obj/effect/turf_decal/tile/neutral{
	dir = 1
	},
/turf/open/floor/mineral/titanium/blue,
/area/shuttle/escape)
"aS" = (
/obj/effect/turf_decal/tile/neutral,
/obj/effect/turf_decal/tile/neutral{
	dir = 8
	},
/turf/open/floor/mineral/titanium/blue,
/area/shuttle/escape)
"aT" = (
/obj/effect/turf_decal/tile/neutral,
/obj/effect/turf_decal/tile/neutral{
	dir = 8
	},
/obj/effect/turf_decal/tile/neutral{
	dir = 4
	},
/turf/open/floor/mineral/titanium/blue,
/area/shuttle/escape)
"aU" = (
/obj/machinery/suit_storage_unit/standard_unit,
/obj/effect/turf_decal/bot,
/turf/open/floor/plasteel/dark,
/area/shuttle/escape)
"aV" = (
/obj/structure/chair/comfy/shuttle{
	dir = 8
	},
/obj/machinery/light{
	dir = 4
	},
/turf/open/floor/plasteel/dark,
/area/shuttle/escape)
"aW" = (
/obj/machinery/door/airlock/shuttle{
	name = "Emergency Shuttle Airlock";
	req_one_access_txt = "63"
	},
/obj/structure/fans/tiny,
/turf/open/floor/plasteel/dark,
/area/shuttle/escape)
"aX" = (
/obj/structure/chair/comfy/shuttle{
	dir = 1
	},
/turf/open/floor/mineral/plastitanium/red/brig,
/area/shuttle/escape)
"aY" = (
/obj/structure/table,
/obj/item/storage/box/zipties{
	pixel_y = 4
	},
/obj/item/restraints/handcuffs,
/obj/item/restraints/handcuffs,
/turf/open/floor/mineral/plastitanium/red/brig,
/area/shuttle/escape)
"aZ" = (
/obj/structure/chair/comfy/shuttle{
	dir = 8
	},
/turf/open/floor/plasteel/dark,
/area/shuttle/escape)
"ba" = (
/obj/machinery/door/airlock/security/glass{
	name = "Holding Area";
	req_access_txt = "2"
	},
/turf/open/floor/plasteel/dark,
/area/shuttle/escape)
"bb" = (
/obj/structure/closet/emcloset,
/obj/effect/turf_decal/tile/neutral{
	dir = 1
	},
/obj/effect/turf_decal/tile/neutral{
	dir = 4
	},
/obj/effect/turf_decal/tile/neutral{
	dir = 8
	},
/turf/open/floor/mineral/titanium/blue,
/area/shuttle/escape)
"bc" = (
/obj/effect/turf_decal/tile/neutral{
	dir = 1
	},
/obj/effect/turf_decal/tile/neutral{
	dir = 4
	},
/turf/open/floor/mineral/titanium/blue,
/area/shuttle/escape)
"bd" = (
/obj/structure/table,
/obj/item/tank/internals/emergency_oxygen{
	pixel_x = -4
	},
/obj/item/tank/internals/air{
	pixel_x = 4
	},
/obj/item/clothing/mask/breath{
	pixel_x = 4;
	pixel_y = 4
	},
/obj/item/clothing/mask/breath,
/obj/effect/turf_decal/tile/neutral{
	dir = 1
	},
/obj/effect/turf_decal/tile/neutral{
	dir = 4
	},
/obj/effect/turf_decal/tile/neutral,
/turf/open/floor/mineral/titanium/blue,
/area/shuttle/escape)
"be" = (
/obj/machinery/door/airlock/shuttle{
	name = "Emergency Shuttle Airlock"
	},
/turf/open/floor/plasteel/dark,
/area/shuttle/escape)
"bf" = (
/obj/machinery/door/airlock/shuttle{
	name = "Emergency Shuttle Airlock"
	},
/obj/docking_port/mobile/emergency{
	name = "Kilo emergency shuttle"
	},
/obj/structure/fans/tiny,
/turf/open/floor/plasteel/dark,
/area/shuttle/escape)
"bg" = (
/obj/machinery/status_display/evac,
/turf/closed/wall/mineral/titanium,
/area/shuttle/escape)
"bh" = (
/obj/structure/sign/warning/securearea,
/turf/closed/wall/mineral/titanium,
/area/shuttle/escape)
"bi" = (
/turf/open/floor/mineral/titanium/white,
/area/shuttle/escape)
"bj" = (
/obj/structure/chair/comfy/shuttle,
/obj/effect/turf_decal/tile/neutral{
	dir = 1
	},
/obj/effect/turf_decal/tile/neutral{
	dir = 4
	},
/turf/open/floor/mineral/titanium/blue,
/area/shuttle/escape)
"bk" = (
/obj/structure/sign/departments/security{
	pixel_y = 32
	},
/obj/machinery/light{
	dir = 1
	},
/obj/structure/chair/comfy/shuttle,
/obj/effect/turf_decal/tile/neutral{
	dir = 1
	},
/obj/effect/turf_decal/tile/neutral{
	dir = 4
	},
/turf/open/floor/mineral/titanium/blue,
/area/shuttle/escape)
"bl" = (
/obj/structure/sign/departments/engineering{
	pixel_y = 32
	},
/obj/machinery/light{
	dir = 1
	},
/obj/structure/chair/comfy/shuttle,
/obj/effect/turf_decal/tile/neutral{
	dir = 1
	},
/obj/effect/turf_decal/tile/neutral{
	dir = 4
	},
/turf/open/floor/mineral/titanium/blue,
/area/shuttle/escape)
"bm" = (
/obj/structure/chair/comfy/shuttle{
	dir = 4
	},
/obj/machinery/status_display/evac{
	pixel_x = -32
	},
/obj/effect/turf_decal/tile/neutral{
	dir = 8
	},
/obj/effect/turf_decal/tile/neutral{
	dir = 1
	},
/turf/open/floor/mineral/titanium/blue,
/area/shuttle/escape)
"bn" = (
/obj/structure/chair/comfy/shuttle{
	dir = 8
	},
/obj/machinery/status_display/evac{
	pixel_x = 32
	},
/obj/effect/turf_decal/tile/neutral{
	dir = 4
	},
/obj/effect/turf_decal/tile/neutral,
/turf/open/floor/mineral/titanium/blue,
/area/shuttle/escape)
"bo" = (
/obj/structure/chair/comfy/shuttle{
	dir = 4
	},
/obj/effect/turf_decal/tile/neutral{
	dir = 8
	},
/obj/effect/turf_decal/tile/neutral{
	dir = 1
	},
/turf/open/floor/mineral/titanium/blue,
/area/shuttle/escape)
"bp" = (
/obj/structure/chair/comfy/shuttle{
	dir = 1
	},
/obj/effect/turf_decal/tile/neutral,
/obj/effect/turf_decal/tile/neutral{
	dir = 8
	},
/turf/open/floor/mineral/titanium/blue,
/area/shuttle/escape)
"bq" = (
/obj/structure/chair/comfy/shuttle{
	dir = 8
	},
/obj/effect/turf_decal/tile/neutral{
	dir = 4
	},
/obj/effect/turf_decal/tile/neutral,
/turf/open/floor/mineral/titanium/blue,
/area/shuttle/escape)
"br" = (
/obj/machinery/door/airlock/shuttle{
	name = "Emergency Shuttle Airlock"
	},
/obj/structure/fans/tiny,
/turf/open/floor/plasteel/dark,
/area/shuttle/escape)
"bs" = (
/obj/structure/chair/comfy/shuttle{
	dir = 1
	},
/obj/item/radio/intercom{
	pixel_y = -28
	},
/obj/machinery/light,
/obj/effect/turf_decal/tile/neutral,
/obj/effect/turf_decal/tile/neutral{
	dir = 8
	},
/turf/open/floor/mineral/titanium/blue,
/area/shuttle/escape)
"bt" = (
/obj/structure/chair/comfy/shuttle{
	dir = 1
	},
/obj/effect/turf_decal/tile/neutral{
	dir = 8
	},
/turf/open/floor/mineral/titanium/blue,
/area/shuttle/escape)
"bu" = (
/obj/structure/chair/comfy/shuttle{
	dir = 1
	},
/obj/effect/turf_decal/tile/neutral,
/turf/open/floor/mineral/titanium/blue,
/area/shuttle/escape)
"bv" = (
/obj/machinery/door/airlock/shuttle{
	name = "Emergency Shuttle Airlock"
	},
/obj/effect/turf_decal/stripes/line,
/obj/effect/turf_decal/stripes/line{
	dir = 1
	},
/turf/open/floor/plasteel/dark,
/area/shuttle/escape)
"bw" = (
/obj/structure/table,
/obj/item/storage/firstaid/o2,
/obj/item/tank/internals/emergency_oxygen,
/obj/effect/turf_decal/tile/neutral{
	dir = 1
	},
/obj/effect/turf_decal/tile/neutral{
	dir = 8
	},
/turf/open/floor/mineral/titanium/blue,
/area/shuttle/escape)
"bx" = (
/obj/structure/table,
/obj/item/storage/toolbox/emergency,
/obj/item/crowbar/red,
/obj/effect/turf_decal/tile/neutral{
	dir = 4
	},
/obj/effect/turf_decal/tile/neutral,
/turf/open/floor/mineral/titanium/blue,
/area/shuttle/escape)
"by" = (
/obj/structure/closet/crate{
	name = "emergency supplies crate"
	},
/obj/item/storage/toolbox/emergency,
/obj/item/storage/toolbox/emergency,
/obj/item/flashlight/flare{
	pixel_x = 3;
	pixel_y = 3
	},
/obj/item/flashlight/flare{
	pixel_x = -6;
	pixel_y = -2
	},
/obj/item/crowbar,
/obj/item/wrench,
/obj/item/radio,
/obj/effect/turf_decal/bot,
/turf/open/floor/plasteel/dark,
/area/shuttle/escape)
"bz" = (
/obj/machinery/door/airlock/medical/glass{
	name = "Shuttle Infirmary"
	},
/turf/open/floor/plasteel/dark,
/area/shuttle/escape)
"bA" = (
/obj/structure/rack,
/obj/item/radio{
	pixel_x = -6;
	pixel_y = 6
	},
/obj/item/radio{
	pixel_x = 6;
	pixel_y = 6
	},
/obj/item/radio{
	pixel_y = 4
	},
/obj/effect/turf_decal/bot,
/turf/open/floor/plasteel/dark,
/area/shuttle/escape)
"bB" = (
/obj/effect/turf_decal/stripes/line{
	dir = 8
	},
/turf/open/floor/mineral/titanium/yellow,
/area/shuttle/escape)
"bC" = (
/obj/structure/closet/crate/medical{
	name = "medical crate"
	},
/obj/item/storage/firstaid/regular,
/obj/item/storage/firstaid/o2{
	pixel_x = 3;
	pixel_y = 3
	},
/obj/item/storage/firstaid/toxin{
	pixel_x = -4;
	pixel_y = 3
	},
/obj/item/healthanalyzer{
	pixel_x = 3;
	pixel_y = 3
	},
/obj/item/lazarus_injector,
/obj/effect/turf_decal/bot,
/mob/living/simple_animal/bot/medbot{
	name = "\improper emergency medibot";
	pixel_x = -3;
	pixel_y = 2
	},
/turf/open/floor/plasteel/dark,
/area/shuttle/escape)
"bD" = (
/obj/machinery/sleeper{
	dir = 4
	},
/obj/effect/turf_decal/tile/neutral{
	dir = 1
	},
/obj/effect/turf_decal/tile/neutral{
	dir = 4
	},
/obj/effect/turf_decal/bot,
/turf/open/floor/mineral/titanium/blue,
/area/shuttle/escape)
"bE" = (
/obj/machinery/sleeper{
	dir = 8
	},
/obj/effect/turf_decal/tile/neutral{
	dir = 1
	},
/obj/effect/turf_decal/tile/neutral{
	dir = 4
	},
/obj/effect/turf_decal/bot,
/turf/open/floor/mineral/titanium/blue,
/area/shuttle/escape)
"bF" = (
/obj/effect/turf_decal/delivery,
/obj/machinery/recharge_station,
/turf/open/floor/plasteel/dark,
/area/shuttle/escape)
"bH" = (
/obj/structure/reagent_dispensers/watertank,
/obj/effect/turf_decal/bot,
/turf/open/floor/plasteel/dark,
/area/shuttle/escape)
"bI" = (
/obj/structure/rack,
/obj/item/storage/toolbox/electrical{
	pixel_x = -3;
	pixel_y = 1
	},
/obj/item/storage/toolbox/mechanical{
	pixel_y = -1
	},
/obj/item/storage/toolbox/emergency{
	pixel_x = 3;
	pixel_y = -5
	},
/obj/machinery/light{
	dir = 4
	},
/obj/effect/turf_decal/bot,
/turf/open/floor/plasteel/dark,
/area/shuttle/escape)
"bJ" = (
/obj/structure/sink{
	dir = 8;
	pixel_x = -12;
	pixel_y = 2
	},
/obj/effect/turf_decal/stripes/white/corner{
	dir = 1
	},
/obj/effect/turf_decal/tile/neutral{
	dir = 1
	},
/turf/open/floor/mineral/titanium/blue,
/area/shuttle/escape)
"bK" = (
/turf/open/floor/mineral/titanium/blue,
/area/shuttle/escape)
"bL" = (
/obj/structure/sink{
	dir = 4;
	pixel_x = 11
	},
/obj/effect/turf_decal/stripes/white/corner,
/obj/effect/turf_decal/tile/neutral{
	dir = 4
	},
/turf/open/floor/mineral/titanium/blue,
/area/shuttle/escape)
"bM" = (
/obj/item/clothing/suit/hazardvest{
	desc = "A high-visibility lifejacket complete with whistle and slot for oxygen tanks.";
	name = "emergency lifejacket"
	},
/obj/item/clothing/suit/hazardvest{
	desc = "A high-visibility lifejacket complete with whistle and slot for oxygen tanks.";
	name = "emergency lifejacket"
	},
/obj/item/tank/internals/emergency_oxygen{
	pixel_x = 3
	},
/obj/item/tank/internals/emergency_oxygen{
	pixel_x = 3
	},
/obj/item/clothing/mask/breath{
	pixel_x = -3;
	pixel_y = -3
	},
/obj/item/clothing/mask/breath{
	pixel_x = -3;
	pixel_y = -3
	},
/obj/item/clothing/head/hardhat/orange{
	name = "protective hat";
	pixel_y = 9
	},
/obj/item/clothing/head/hardhat/orange{
	name = "protective hat";
	pixel_y = 9
	},
/obj/structure/closet/crate/internals,
/obj/machinery/light{
	dir = 8
	},
/obj/effect/turf_decal/bot,
/turf/open/floor/plasteel/dark,
/area/shuttle/escape)
"bN" = (
/obj/machinery/vending/wallmed{
	name = "Emergency NanoMed";
	use_power = 0
	},
/turf/closed/wall/mineral/titanium/nodiagonal,
/area/shuttle/escape)
"bO" = (
/obj/structure/flora/ausbushes/grassybush,
/obj/structure/flora/ausbushes/lavendergrass,
/obj/structure/flora/ausbushes/brflowers,
/obj/structure/flora/ausbushes/leafybush,
/obj/structure/window/shuttle,
/turf/open/floor/grass,
/area/shuttle/escape)
"bP" = (
/obj/structure/flora/ausbushes/grassybush,
/obj/structure/flora/ausbushes/lavendergrass,
/obj/structure/flora/ausbushes/ywflowers,
/obj/structure/flora/ausbushes/fernybush,
/obj/structure/window/shuttle,
/turf/open/floor/grass,
/area/shuttle/escape)
"bQ" = (
/obj/structure/extinguisher_cabinet,
/turf/closed/wall/mineral/titanium/nodiagonal,
/area/shuttle/escape)
"bR" = (
/obj/item/clothing/suit/hazardvest{
	desc = "A high-visibility lifejacket complete with whistle and slot for oxygen tanks.";
	name = "emergency lifejacket"
	},
/obj/item/clothing/suit/hazardvest{
	desc = "A high-visibility lifejacket complete with whistle and slot for oxygen tanks.";
	name = "emergency lifejacket"
	},
/obj/item/tank/internals/emergency_oxygen{
	pixel_x = 3
	},
/obj/item/tank/internals/emergency_oxygen{
	pixel_x = 3
	},
/obj/item/clothing/mask/breath{
	pixel_x = -3;
	pixel_y = -3
	},
/obj/item/clothing/mask/breath{
	pixel_x = -3;
	pixel_y = -3
	},
/obj/item/clothing/head/hardhat/orange{
	name = "protective hat";
	pixel_y = 9
	},
/obj/item/clothing/head/hardhat/orange{
	name = "protective hat";
	pixel_y = 9
	},
/obj/structure/closet/crate/internals,
/obj/effect/turf_decal/bot,
/turf/open/floor/plasteel/dark,
/area/shuttle/escape)
"bS" = (
/obj/machinery/vending/medical,
/obj/machinery/light{
	dir = 8
	},
/obj/effect/turf_decal/bot,
/turf/open/floor/plasteel/dark,
/area/shuttle/escape)
"bT" = (
/obj/effect/turf_decal/stripes/white/line{
	dir = 5
	},
/turf/open/floor/mineral/titanium/blue,
/area/shuttle/escape)
"bU" = (
/obj/effect/turf_decal/stripes/white/line{
	dir = 3
	},
/turf/open/floor/mineral/titanium/blue,
/area/shuttle/escape)
"bV" = (
/obj/effect/turf_decal/stripes/white/corner,
/obj/effect/turf_decal/stripes/white/corner{
	dir = 1
	},
/turf/open/floor/mineral/titanium/blue,
/area/shuttle/escape)
"bW" = (
/obj/effect/turf_decal/stripes/white/line,
/turf/open/floor/mineral/titanium/blue,
/area/shuttle/escape)
"bX" = (
/obj/effect/turf_decal/stripes/white/line{
	dir = 9
	},
/turf/open/floor/mineral/titanium/blue,
/area/shuttle/escape)
"bY" = (
/obj/structure/table,
/obj/machinery/light{
	dir = 4
	},
/obj/item/book/manual/wiki/surgery,
/obj/item/razor,
/obj/item/clothing/mask/surgical,
/obj/item/clothing/suit/apron/surgical,
/obj/item/clothing/gloves/color/latex,
/obj/item/reagent_containers/medspray/sterilizine,
/turf/open/floor/plasteel/dark,
/area/shuttle/escape)
"bZ" = (
/obj/structure/table,
/obj/item/defibrillator/loaded,
/turf/open/floor/plasteel/dark,
/area/shuttle/escape)
"ca" = (
/obj/structure/table,
/obj/item/storage/firstaid/fire{
	pixel_x = 4;
	pixel_y = 4
	},
/obj/item/storage/firstaid/regular{
	pixel_x = 2;
	pixel_y = 2
	},
/obj/item/storage/firstaid/regular,
/turf/open/floor/plasteel/dark,
/area/shuttle/escape)
"cb" = (
/obj/structure/table,
/obj/item/clipboard,
/obj/item/reagent_containers/hypospray/medipen,
/obj/item/reagent_containers/hypospray/medipen{
	pixel_y = 6
	},
/obj/item/reagent_containers/hypospray/medipen{
	pixel_y = -6
	},
/obj/item/reagent_containers/glass/bottle/charcoal,
/turf/open/floor/plasteel/dark,
/area/shuttle/escape)
"cc" = (
/obj/machinery/computer/operating{
	dir = 1
	},
/obj/effect/turf_decal/bot,
/turf/open/floor/plasteel/dark,
/area/shuttle/escape)
"cd" = (
/obj/structure/table/optable,
/obj/effect/turf_decal/bot,
/turf/open/floor/plasteel/dark,
/area/shuttle/escape)
"ce" = (
/obj/structure/table,
/obj/item/scalpel,
/obj/item/circular_saw{
	pixel_y = 8
	},
/obj/item/retractor,
/obj/item/hemostat,
/obj/item/surgicaldrill,
/obj/item/surgical_drapes,
/turf/open/floor/plasteel/dark,
/area/shuttle/escape)
"cj" = (
/turf/open/floor/mineral/titanium/yellow,
/area/shuttle/escape)
"ck" = (
/obj/effect/turf_decal/stripes/line{
	dir = 4
	},
/turf/open/floor/mineral/titanium/yellow,
/area/shuttle/escape)
"cm" = (
/obj/structure/sign/departments/medbay/alt,
/turf/closed/wall/mineral/titanium,
/area/shuttle/escape)
"cr" = (
/obj/effect/turf_decal/stripes/line,
/turf/open/floor/mineral/titanium/yellow,
/area/shuttle/escape)
"cs" = (
/obj/effect/turf_decal/stripes/line{
	dir = 6
	},
/turf/open/floor/mineral/titanium/yellow,
/area/shuttle/escape)
"cA" = (
/obj/effect/turf_decal/stripes/line{
	dir = 10
	},
/turf/open/floor/mineral/titanium/yellow,
/area/shuttle/escape)
"cK" = (
/obj/effect/spawner/structure/window/shuttle,
/obj/structure/shuttle/engine/heater,
/turf/open/floor/plating,
/area/shuttle/escape)
"cL" = (
/obj/structure/sign/warning/fire,
/turf/closed/wall/mineral/titanium,
/area/shuttle/escape)
"cS" = (
/turf/closed/wall/mineral/plastitanium,
/area/shuttle/escape)
"cT" = (
/obj/structure/shuttle/engine/propulsion,
/obj/effect/turf_decal/stripes/line,
/turf/open/floor/plating/airless,
/area/shuttle/escape)
"cU" = (
/turf/closed/wall/mineral/plastitanium/nodiagonal,
/area/shuttle/escape)
"cY" = (
/obj/machinery/status_display/ai,
/turf/closed/wall/mineral/titanium,
/area/shuttle/escape)
"dd" = (
/obj/structure/shuttle/engine/propulsion/left,
/obj/effect/turf_decal/stripes/line,
/turf/open/floor/plating/airless,
/area/shuttle/escape)
"de" = (
/obj/structure/shuttle/engine/propulsion/right,
/obj/effect/turf_decal/stripes/line,
/turf/open/floor/plating/airless,
/area/shuttle/escape)
"dg" = (
/obj/effect/turf_decal/stripes/line{
	dir = 1
	},
/turf/open/floor/plating/airless,
/area/shuttle/escape)
"dh" = (
/obj/structure/shuttle/engine/heater,
/turf/closed/wall/mineral/plastitanium,
/area/shuttle/escape)
"di" = (
/obj/effect/turf_decal/stripes/line,
/obj/structure/shuttle/engine/large,
/turf/open/floor/plating/airless,
/area/shuttle/escape)
"dj" = (
/obj/effect/turf_decal/stripes/line,
/turf/open/floor/plating/airless,
/area/shuttle/escape)
"Xo" = (
/obj/effect/turf_decal/stripes/line{
	dir = 8
	},
/obj/effect/turf_decal/stripes/corner{
	dir = 8
	},
/obj/effect/turf_decal/stripes/corner,
/turf/open/floor/mineral/titanium/yellow,
/area/shuttle/escape)

(1,1,1) = {"
aa
aa
ab
ac
ab
ac
ai
aW
ab
bf
ab
ac
ac
ac
ab
br
ab
br
ai
ab
as
cS
aa
aa
aa
"}
(2,1,1) = {"
aa
aa
ac
ap
ay
ay
aP
az
ac
bi
bm
bo
bo
bo
bm
bi
ac
cj
cr
bH
cK
cT
aa
aa
aa
"}
(3,1,1) = {"
aa
aa
ab
aq
az
az
az
az
ba
bi
bi
bi
bi
bi
bi
bi
bv
ck
cs
bI
cL
cU
cS
cS
aa
"}
(4,1,1) = {"
aa
aa
ac
ar
az
az
az
aX
ac
bi
bi
bp
bN
bj
bi
bp
ac
by
bC
as
ab
ab
as
cS
cS
"}
(5,1,1) = {"
ab
ac
ai
as
aA
az
aQ
aY
ab
bj
bi
bp
bO
bj
bi
bs
as
ab
bg
as
bS
bZ
cK
dg
di
"}
(6,1,1) = {"
ac
ad
aj
as
aD
aG
ac
as
as
bk
bi
bp
bP
bj
bi
bt
bw
cm
bD
bJ
bT
ca
cK
dg
dj
"}
(7,1,1) = {"
ac
ae
ak
at
aB
aH
aR
bg
bb
bi
bi
bp
bQ
bj
bi
bi
bi
bz
bc
bK
bU
cb
cL
dh
de
"}
(8,1,1) = {"
ac
af
al
au
aC
aI
aS
aK
bc
bi
bi
bi
bi
bi
bi
bi
bi
ac
bc
bK
bV
cY
ab
cS
cS
"}
(9,1,1) = {"
ac
ag
am
av
aE
aJ
aT
bh
bd
bi
bi
bp
bN
bj
bi
bi
bi
bz
bc
bK
bW
cc
cL
dh
dd
"}
(10,1,1) = {"
ac
ah
an
as
as
aK
ab
as
as
bl
bi
bp
bO
bj
bi
bu
bx
cm
bE
bL
bX
cd
cK
dg
di
"}
(11,1,1) = {"
ab
ac
ai
as
as
aL
aU
aU
ab
bj
bi
bp
bP
bj
bi
bs
as
ab
bg
as
bY
ce
cK
dg
dj
"}
(12,1,1) = {"
aa
aa
ab
aw
ab
aM
bB
bB
ac
bi
bi
bp
bQ
bj
bi
bp
ac
bA
bF
as
ab
ab
as
cS
cS
"}
(13,1,1) = {"
aa
aa
ao
Xo
aF
aN
cj
cj
be
bi
bi
bi
bi
bi
bi
bi
bv
bB
cA
bM
cL
cU
cS
cS
aa
"}
(14,1,1) = {"
aa
aa
ab
ax
ab
aO
aV
aZ
ac
bi
bn
bq
bq
bq
bn
bi
ac
cj
cr
bR
cK
cT
aa
aa
aa
"}
(15,1,1) = {"
aa
aa
ab
ab
ab
ac
ai
ac
ab
ac
ab
ac
ac
ac
ab
ac
ab
ab
ai
ab
as
cS
aa
aa
aa
"}
