//MAP CONVERTED BY dmm2tgm.py THIS HEADER COMMENT PREVENTS RECONVERSION, DO NOT REMOVE
"a" = (
/turf/closed/wall/mineral/titanium,
/area/shuttle/snowtaxi)
"b" = (
/obj/structure/shuttle/engine/propulsion/burst{
	dir = 4
	},
/obj/structure/window/reinforced{
	dir = 8
	},
/obj/structure/fans/tiny/invisible,
/turf/open/floor/plating,
/area/shuttle/snowtaxi)
"c" = (
/obj/machinery/door/airlock/titanium{
	name = "Mining Shuttle Airlock"
	},
/obj/effect/mapping_helpers/airlock/cyclelink_helper,
/obj/structure/fans/tiny,
/turf/open/floor/plating,
/area/shuttle/snowtaxi)
"e" = (
/obj/effect/spawner/structure/window/shuttle,
/obj/structure/fans/tiny/invisible,
/turf/open/floor/plating,
/area/shuttle/snowtaxi)
"f" = (
/obj/machinery/light{
	dir = 1
	},
/obj/structure/chair/comfy/shuttle{
	dir = 8
	},
/turf/open/floor/mineral/titanium,
/area/shuttle/snowtaxi)
"g" = (
/obj/machinery/door/airlock/titanium{
	name = "Mining Shuttle Airlock"
	},
/obj/docking_port/mobile{
	callTime = 5;
	dwidth = 3;
	height = 4;
	id = "snow_taxi";
	name = "snow taxi";
	port_direction = 8;
	width = 6
	},
/obj/effect/mapping_helpers/airlock/cyclelink_helper{
	dir = 1
	},
/obj/structure/fans/tiny,
/turf/open/floor/plating,
/area/shuttle/snowtaxi)
"i" = (
/obj/machinery/light,
/obj/machinery/computer/shuttle/snow_taxi{
	dir = 4
	},
/turf/open/floor/mineral/titanium,
/area/shuttle/snowtaxi)
"j" = (
/obj/structure/chair/comfy/shuttle{
	dir = 1
	},
/turf/open/floor/mineral/titanium,
/area/shuttle/snowtaxi)
"k" = (
/turf/open/floor/mineral/titanium,
/area/shuttle/snowtaxi)
"l" = (
/obj/effect/spawner/structure/window/shuttle,
/obj/structure/fans/tiny/invisible,
/turf/open/floor/plating/airless,
/area/shuttle/snowtaxi)
"u" = (
/obj/structure/chair/comfy/shuttle,
/turf/open/floor/mineral/titanium,
/area/shuttle/snowtaxi)

(1,1,1) = {"
a
e
e
a
"}
(2,1,1) = {"
a
f
i
a
"}
(3,1,1) = {"
e
u
j
l
"}
(4,1,1) = {"
c
k
k
g
"}
(5,1,1) = {"
a
u
j
a
"}
(6,1,1) = {"
a
b
b
a
"}
