//MAP CONVERTED BY dmm2tgm.py THIS HEADER COMMENT PREVENTS RECONVERSION, DO NOT REMOVE
"a" = (
/turf/open/space/basic,
/area/space)
"b" = (
/obj/machinery/porta_turret/syndicate/energy/heavy{
	dir = 1
	},
/turf/closed/wall/mineral/plastitanium/nodiagonal,
/area/shuttle/sbc/corvette)
"c" = (
/obj/structure/cable{
	icon_state = "0-4"
	},
/obj/structure/cable{
	icon_state = "0-8"
	},
/obj/effect/spawner/structure/window/plastitanium,
/turf/open/floor/plating,
/area/shuttle/sbc/corvette)
"d" = (
/turf/closed/wall/r_wall/syndicate/nodiagonal,
/area/shuttle/sbc/corvette)
"e" = (
/turf/open/floor/mineral/plastitanium,
/area/shuttle/sbc/corvette)
"f" = (
/obj/machinery/light,
/turf/open/floor/mineral/plastitanium,
/area/shuttle/sbc/corvette)
"g" = (
/obj/structure/shuttle/engine/propulsion,
/turf/open/space/basic,
/area/shuttle/sbc/corvette)
"h" = (
/obj/structure/chair/comfy/shuttle{
	dir = 4
	},
/obj/machinery/turretid{
	ailock = 1;
	desc = "A specially designed set of turret controls. Looks to be covered in protective casing to prevent AI interfacing.";
	icon_state = "control_stun";
	name = "Ship Turret Control";
	pixel_y = 32;
	req_access = 150
	},
/turf/open/floor/mineral/plastitanium,
/area/shuttle/sbc/corvette)
"i" = (
/obj/structure/chair/comfy/shuttle{
	dir = 8
	},
/turf/open/floor/mineral/plastitanium,
/area/shuttle/sbc/corvette)
"j" = (
/obj/structure/chair/comfy/shuttle,
/turf/open/floor/mineral/plastitanium,
/area/shuttle/sbc/corvette)
"k" = (
/obj/structure/cable{
	icon_state = "2-4"
	},
/turf/closed/wall/r_wall/syndicate/nodiagonal,
/area/shuttle/sbc/corvette)
"l" = (
/obj/machinery/computer/camera_advanced/shuttle_docker/syndicate{
	dir = 1;
	jumpto_ports = list("sbcfighter_BAY2" = 1, "syndicate_ne" = 1, "syndicate_nw" = 1, "syndicate_n" = 1, "syndicate_se" = 1, "syndicate_sw" = 1, "syndicate_s" = 1);
	name = "Syndicate Corvette Navigation Console";
	shuttleId = "sbccorvette";
	shuttlePortId = "sbccorvette_custom";
	view_range = 14
	},
/turf/open/floor/mineral/plastitanium,
/area/shuttle/sbc/corvette)
"m" = (
/obj/machinery/computer/shuttle/syndicate{
	dir = 1;
	name = "Syndicate Corvette Console";
	possible_destinations = "sbcfighter_BAY2;sbccorvette_custom;syndicate_nw";
	shuttleId = "sbccorvette"
	},
/turf/open/floor/mineral/plastitanium,
/area/shuttle/sbc/corvette)
"n" = (
/obj/structure/table/reinforced,
/obj/item/binoculars,
/turf/open/floor/mineral/plastitanium,
/area/shuttle/sbc/corvette)
"o" = (
/obj/structure/table/reinforced,
/obj/item/storage/toolbox/mechanical,
/obj/item/multitool,
/turf/open/floor/mineral/plastitanium,
/area/shuttle/sbc/corvette)
"p" = (
/obj/structure/table/reinforced,
/obj/item/tank/internals/emergency_oxygen/engi,
/obj/item/tank/internals/emergency_oxygen/engi,
/obj/item/tank/internals/emergency_oxygen/engi,
/obj/item/tank/internals/emergency_oxygen/engi,
/obj/item/clothing/mask/gas/syndicate,
/obj/item/clothing/mask/gas/syndicate,
/obj/item/clothing/mask/gas/syndicate,
/obj/item/clothing/mask/gas/syndicate,
/turf/open/floor/mineral/plastitanium,
/area/shuttle/sbc/corvette)
"q" = (
/obj/structure/table/reinforced,
/obj/item/storage/fancy/donut_box,
/turf/open/floor/mineral/plastitanium,
/area/shuttle/sbc/corvette)
"r" = (
/obj/structure/table/reinforced,
/obj/item/storage/fancy/cigarettes/cigpack_syndicate,
/obj/item/lighter{
	pixel_x = 6
	},
/turf/open/floor/mineral/plastitanium,
/area/shuttle/sbc/corvette)
"s" = (
/obj/machinery/power/apc/syndicate{
	pixel_y = -28
	},
/obj/structure/cable{
	icon_state = "0-4"
	},
/turf/open/floor/mineral/plastitanium,
/area/shuttle/sbc/corvette)
"t" = (
/obj/structure/cable{
	icon_state = "1-2"
	},
/turf/open/floor/mineral/plastitanium,
/area/shuttle/sbc/corvette)
"u" = (
/obj/machinery/power/smes,
/obj/structure/cable{
	d2 = 8
	},
/turf/open/floor/mineral/plastitanium,
/area/shuttle/sbc/corvette)
"v" = (
/obj/machinery/power/terminal{
	dir = 1
	},
/obj/structure/cable{
	icon_state = "0-4"
	},
/obj/structure/cable{
	icon_state = "0-8"
	},
/turf/open/floor/mineral/plastitanium,
/area/shuttle/sbc/corvette)
"w" = (
/obj/structure/cable{
	icon_state = "0-4"
	},
/obj/structure/cable{
	icon_state = "0-8"
	},
/obj/structure/cable{
	icon_state = "2-8"
	},
/obj/structure/cable{
	icon_state = "2-4"
	},
/obj/effect/spawner/structure/window/plastitanium,
/turf/open/floor/plating,
/area/shuttle/sbc/corvette)
"x" = (
/obj/structure/chair/comfy/shuttle{
	dir = 4
	},
/turf/open/floor/mineral/plastitanium,
/area/shuttle/sbc/corvette)
"A" = (
/obj/machinery/door/airlock/external{
	id_tag = "sbc_corvette_bolt";
	name = "Syndicate Corvette Airlock";
	req_access_txt = "150"
	},
/obj/structure/cable{
	icon_state = "1-2"
	},
/obj/structure/fans/tiny,
/turf/open/floor/mineral/plastitanium,
/area/shuttle/sbc/corvette)
"B" = (
/obj/machinery/door/airlock/external{
	id_tag = "sbc_corvette_bolt";
	name = "Syndicate Corvette Airlock";
	req_access_txt = "150"
	},
/obj/docking_port/mobile{
	height = 6;
	id = "sbccorvette";
	movement_force = list("KNOCKDOWN" = 1, "THROW" = 0);
	name = "Syndicate Corvette";
	port_direction = 2;
	width = 12
	},
/obj/structure/fans/tiny,
/turf/open/floor/mineral/plastitanium,
/area/shuttle/sbc/corvette)
"C" = (
/obj/structure/cable{
	d2 = 8
	},
/obj/structure/cable{
	icon_state = "0-2"
	},
/obj/effect/spawner/structure/window/plastitanium,
/turf/open/floor/plating,
/area/shuttle/sbc/corvette)
"F" = (
/obj/structure/cable{
	icon_state = "1-8"
	},
/turf/closed/wall/r_wall/syndicate/nodiagonal,
/area/shuttle/sbc/corvette)
"H" = (
/obj/structure/cable{
	icon_state = "4-8"
	},
/turf/open/floor/mineral/plastitanium,
/area/shuttle/sbc/corvette)
"K" = (
/obj/structure/cable{
	icon_state = "2-8"
	},
/turf/closed/wall/r_wall/syndicate/nodiagonal,
/area/shuttle/sbc/corvette)
"L" = (
/obj/machinery/porta_turret/syndicate/energy/heavy{
	dir = 1
	},
/obj/structure/cable{
	icon_state = "2-4"
	},
/turf/closed/wall/mineral/plastitanium/nodiagonal,
/area/shuttle/sbc/corvette)
"M" = (
/obj/machinery/door/airlock/external{
	id_tag = "sbc_corvette_bolt";
	name = "Syndicate Corvette Airlock";
	req_access_txt = "150"
	},
/turf/open/floor/mineral/plastitanium,
/area/shuttle/sbc/corvette)
"N" = (
/obj/structure/cable{
	icon_state = "1-2"
	},
/obj/machinery/door/airlock/external{
	id_tag = "sbc_corvette_bolt";
	name = "Syndicate Corvette Airlock";
	req_access_txt = "150"
	},
/turf/open/floor/mineral/plastitanium,
/area/shuttle/sbc/corvette)
"O" = (
/obj/machinery/porta_turret/syndicate/energy/heavy{
	dir = 1
	},
/obj/structure/cable{
	icon_state = "2-8"
	},
/turf/closed/wall/mineral/plastitanium/nodiagonal,
/area/shuttle/sbc/corvette)
"Q" = (
/obj/structure/cable{
	d2 = 8
	},
/obj/effect/spawner/structure/window/plastitanium,
/turf/open/floor/plating,
/area/shuttle/sbc/corvette)
"R" = (
/obj/structure/cable{
	icon_state = "1-4"
	},
/turf/closed/wall/r_wall/syndicate/nodiagonal,
/area/shuttle/sbc/corvette)
"V" = (
/obj/structure/cable{
	icon_state = "2-8"
	},
/turf/open/floor/mineral/plastitanium,
/area/shuttle/sbc/corvette)
"Y" = (
/obj/structure/shuttle/engine/propulsion,
/turf/closed/wall/r_wall/syndicate/nodiagonal,
/area/shuttle/sbc/corvette)

(1,1,1) = {"
a
L
C
Q
b
g
"}
(2,1,1) = {"
k
F
h
x
o
d
"}
(3,1,1) = {"
c
j
f
d
d
Y
"}
(4,1,1) = {"
c
j
e
M
e
B
"}
(5,1,1) = {"
b
r
s
d
d
Y
"}
(6,1,1) = {"
c
n
H
e
l
d
"}
(7,1,1) = {"
w
u
v
e
m
d
"}
(8,1,1) = {"
b
q
H
d
d
Y
"}
(9,1,1) = {"
c
j
V
N
t
A
"}
(10,1,1) = {"
c
j
f
d
d
Y
"}
(11,1,1) = {"
K
R
i
i
p
d
"}
(12,1,1) = {"
a
O
C
Q
b
g
"}
