//MAP CONVERTED BY dmm2tgm.py THIS HEADER COMMENT PREVENTS RECONVERSION, DO NOT REMOVE
"b" = (
/turf/closed/mineral/random/high_chance,
/area/ruin/unpowered)
"h" = (
/obj/effect/decal/remains/human,
/turf/open/floor/plating/asteroid,
/area/ruin/unpowered)
"t" = (
/turf/open/floor/plating/asteroid,
/area/ruin/unpowered)
"B" = (
/turf/open/floor/plating/asteroid/airless,
/area/ruin/unpowered)
"G" = (
/obj/item/holosign_creator/atmos,
/turf/open/floor/plating/asteroid,
/area/ruin/unpowered)
"K" = (
/turf/template_noop,
/area/template_noop)
"P" = (
/obj/structure/holosign/barrier/atmos,
/turf/open/floor/plating/asteroid,
/area/ruin/unpowered)
"Y" = (
/obj/structure/fluff/fokoff_sign,
/turf/open/floor/plating/asteroid/airless,
/area/ruin/unpowered)

(1,1,1) = {"
K
K
K
B
B
B
B
K
K
K
K
B
b
b
B
K
K
"}
(2,1,1) = {"
K
K
B
b
b
b
b
B
K
K
B
b
b
b
b
B
K
"}
(3,1,1) = {"
K
B
b
b
b
b
b
b
B
Y
b
b
b
b
b
b
B
"}
(4,1,1) = {"
B
b
b
b
b
b
b
b
b
B
b
b
b
b
b
b
B
"}
(5,1,1) = {"
B
b
b
b
b
b
b
b
b
P
b
b
b
b
b
b
B
"}
(6,1,1) = {"
K
B
b
b
b
b
b
b
t
G
t
b
b
b
b
B
K
"}
(7,1,1) = {"
K
K
B
b
b
b
B
P
t
h
t
t
b
b
b
B
K
"}
(8,1,1) = {"
K
K
K
B
Y
B
B
b
b
b
t
t
P
Y
B
K
K
"}
(9,1,1) = {"
K
K
K
B
B
b
b
b
b
b
b
b
b
B
K
K
K
"}
(10,1,1) = {"
K
K
K
B
b
b
b
b
b
b
b
b
b
b
B
K
K
"}
(11,1,1) = {"
K
K
K
B
b
b
b
b
b
b
b
b
b
B
K
K
K
"}
(12,1,1) = {"
K
K
K
K
B
b
b
b
b
B
B
B
B
K
K
K
K
"}
(13,1,1) = {"
K
K
K
K
K
B
b
b
B
K
K
K
K
K
K
K
K
"}
(14,1,1) = {"
K
K
K
K
K
K
B
B
K
K
K
K
K
K
K
K
K
"}
