//MAP CONVERTED BY dmm2tgm.py THIS HEADER COMMENT PREVENTS RECONVERSION, DO NOT REMOVE
"b" = (
/turf/closed/mineral/random,
/area/ruin/space)
"h" = (
/obj/effect/decal/remains/human,
/turf/open/floor/plating/asteroid,
/area/ruin/space)
"t" = (
/turf/open/floor/plating/asteroid,
/area/ruin/space)
"G" = (
/obj/item/holosign_creator/atmos,
/turf/open/floor/plating/asteroid,
/area/ruin/space)
"K" = (
/turf/template_noop,
/area/template_noop)
"P" = (
/obj/structure/holosign/barrier/atmos,
/turf/open/floor/plating/asteroid,
/area/ruin/space)
"R" = (
/turf/open/floor/plating/asteroid/airless,
/area/ruin/space)
"Y" = (
/obj/structure/fluff/fokoff_sign,
/turf/open/floor/plating/asteroid/airless,
/area/ruin/space)

(1,1,1) = {"
K
K
K
R
R
R
R
K
K
K
K
R
b
b
R
K
K
"}
(2,1,1) = {"
K
K
R
b
b
b
b
R
K
K
R
b
b
b
b
R
K
"}
(3,1,1) = {"
K
R
b
b
b
b
b
b
R
Y
b
b
b
b
b
b
R
"}
(4,1,1) = {"
R
b
b
b
b
b
b
b
b
R
b
b
b
b
b
b
R
"}
(5,1,1) = {"
R
b
b
b
b
b
b
b
b
P
b
b
b
b
b
b
R
"}
(6,1,1) = {"
K
R
b
b
b
b
b
b
t
G
t
b
b
b
b
R
K
"}
(7,1,1) = {"
K
K
R
b
b
b
R
P
t
h
t
t
b
b
b
R
K
"}
(8,1,1) = {"
K
K
K
R
Y
R
R
b
b
b
t
t
P
Y
R
K
K
"}
(9,1,1) = {"
K
K
K
R
R
b
b
b
b
b
b
b
b
R
K
K
K
"}
(10,1,1) = {"
K
K
K
R
b
b
b
b
b
b
b
b
b
b
R
K
K
"}
(11,1,1) = {"
K
K
K
R
b
b
b
b
b
b
b
b
b
R
K
K
K
"}
(12,1,1) = {"
K
K
K
K
R
b
b
b
b
R
R
R
R
K
K
K
K
"}
(13,1,1) = {"
K
K
K
K
K
R
b
b
R
K
K
K
K
K
K
K
K
"}
(14,1,1) = {"
K
K
K
K
K
K
R
R
K
K
K
K
K
K
K
K
K
"}
