//MAP CONVERTED BY dmm2tgm.py THIS HEADER COMMENT PREVENTS RECONVERSION, DO NOT REMOVE
"a" = (
/turf/closed/wall/mineral/iron,
/area/ruin/space/has_grav)
"d" = (
/obj/structure/table/wood,
/obj/item/flashlight/lamp,
/turf/open/floor/wood,
/area/ruin/space/has_grav)
"e" = (
/turf/template_noop,
/area/template_noop)
"f" = (
/obj/structure/bed,
/obj/item/bedsheet,
/turf/open/floor/wood,
/area/ruin/space/has_grav)
"g" = (
/obj/machinery/atmospherics/pipe/simple/scrubbers/hidden/layer1,
/obj/machinery/atmospherics/pipe/simple/supply/hidden,
/obj/machinery/door/airlock/highsecurity,
/turf/open/floor/plasteel,
/area/ruin/space/has_grav)
"h" = (
/obj/machinery/light/small,
/turf/open/floor/wood,
/area/ruin/space/has_grav)
"k" = (
/obj/machinery/atmospherics/pipe/simple/scrubbers/hidden/layer1{
	dir = 4
	},
/turf/open/floor/plasteel,
/area/ruin/space/has_grav)
"l" = (
/obj/structure/dresser,
/turf/open/floor/wood,
/area/ruin/space/has_grav)
"m" = (
/obj/structure/table/wood,
/turf/open/floor/wood,
/area/ruin/space/has_grav)
"n" = (
/turf/open/floor/wood,
/area/ruin/space/has_grav)
"o" = (
/obj/structure/table/wood,
/obj/item/reagent_containers/food/snacks/beans,
/obj/item/reagent_containers/food/snacks/beans,
/obj/machinery/light/small{
	dir = 4
	},
/turf/open/floor/wood,
/area/ruin/space/has_grav)
"p" = (
/obj/machinery/atmospherics/pipe/simple/scrubbers/hidden/layer1{
	dir = 10
	},
/obj/machinery/atmospherics/pipe/manifold/supply/hidden{
	dir = 1
	},
/turf/open/floor/plasteel,
/area/ruin/space/has_grav)
"q" = (
/obj/machinery/atmospherics/components/unary/tank/air{
	dir = 8
	},
/turf/open/floor/plasteel,
/area/ruin/space/has_grav)
"r" = (
/obj/machinery/atmospherics/pipe/simple/scrubbers/hidden/layer1{
	dir = 4
	},
/obj/machinery/atmospherics/pipe/simple/supply/hidden{
	dir = 5
	},
/turf/open/floor/plasteel,
/area/ruin/space/has_grav)
"u" = (
/obj/structure/chair/comfy/black{
	dir = 1
	},
/turf/open/floor/plasteel,
/area/ruin/space/has_grav)
"v" = (
/turf/open/floor/plating/asteroid/airless,
/area/ruin/space)
"w" = (
/obj/machinery/atmospherics/components/unary/vent_pump/on,
/turf/open/floor/plasteel,
/area/ruin/space/has_grav)
"x" = (
/obj/machinery/light/small{
	dir = 8
	},
/turf/open/floor/plasteel,
/area/ruin/space/has_grav)
"y" = (
/obj/machinery/atmospherics/pipe/simple/scrubbers/hidden/layer1,
/obj/machinery/atmospherics/pipe/simple/supply/hidden,
/turf/open/floor/wood,
/area/ruin/space/has_grav)
"z" = (
/obj/machinery/atmospherics/pipe/simple/scrubbers/hidden/layer1{
	dir = 4
	},
/obj/machinery/door/airlock/highsecurity,
/obj/structure/fans/tiny,
/turf/open/floor/plasteel,
/area/ruin/space/has_grav)
"A" = (
/obj/structure/table/wood,
/obj/item/export/bottle/wine,
/obj/item/reagent_containers/food/drinks/drinkingglass,
/obj/item/reagent_containers/food/drinks/drinkingglass,
/turf/open/floor/wood,
/area/ruin/space/has_grav)
"B" = (
/obj/structure/table/wood,
/obj/item/storage/box/donkpockets,
/obj/machinery/atmospherics/components/unary/vent_pump/on{
	dir = 1
	},
/turf/open/floor/wood,
/area/ruin/space/has_grav)
"C" = (
/turf/closed/mineral/random,
/area/ruin/space)
"D" = (
/obj/machinery/atmospherics/components/unary/outlet_injector/on/layer1{
	dir = 1
	},
/turf/open/floor/plating/asteroid/airless,
/area/ruin/space)
"E" = (
/obj/machinery/light/small{
	dir = 4
	},
/turf/open/floor/plasteel,
/area/ruin/space/has_grav)
"F" = (
/obj/structure/table,
/obj/item/storage/firstaid/regular,
/turf/open/floor/plasteel,
/area/ruin/space/has_grav)
"G" = (
/obj/machinery/computer/security,
/turf/open/floor/plasteel,
/area/ruin/space/has_grav)
"J" = (
/obj/machinery/atmospherics/pipe/simple/scrubbers/hidden/layer1{
	dir = 9
	},
/obj/machinery/atmospherics/pipe/simple/supply/hidden,
/turf/open/floor/wood,
/area/ruin/space/has_grav)
"N" = (
/obj/structure/table,
/obj/item/storage/toolbox/mechanical,
/obj/item/clothing/gloves/color/yellow,
/obj/item/multitool,
/turf/open/floor/plasteel,
/area/ruin/space/has_grav)
"O" = (
/turf/open/floor/plasteel,
/area/ruin/space/has_grav)
"P" = (
/obj/machinery/atmospherics/components/unary/vent_scrubber/on/layer1,
/turf/open/floor/plasteel,
/area/ruin/space/has_grav)
"Q" = (
/obj/machinery/atmospherics/components/unary/vent_scrubber/on/layer1{
	dir = 1
	},
/obj/structure/table/wood,
/obj/machinery/microwave,
/turf/open/floor/wood,
/area/ruin/space/has_grav)
"T" = (
/obj/machinery/atmospherics/pipe/simple/scrubbers/hidden/layer1{
	dir = 6
	},
/turf/open/floor/wood,
/area/ruin/space/has_grav)
"U" = (
/obj/machinery/sleeper,
/turf/open/floor/plasteel,
/area/ruin/space/has_grav)
"V" = (
/obj/machinery/computer/crew,
/turf/open/floor/plasteel,
/area/ruin/space/has_grav)
"W" = (
/obj/machinery/atmospherics/pipe/manifold/scrubbers/hidden/layer1,
/obj/machinery/airalarm{
	dir = 1;
	pixel_y = -22
	},
/turf/open/floor/plasteel,
/area/ruin/space/has_grav)
"Y" = (
/obj/machinery/atmospherics/pipe/simple/scrubbers/hidden/layer1{
	dir = 6
	},
/turf/open/floor/plating/asteroid/airless,
/area/ruin/space)

(1,1,1) = {"
e
e
e
e
e
e
v
v
v
e
e
e
e
e
e
v
v
e
e
e
"}
(2,1,1) = {"
e
e
e
e
e
v
C
C
C
v
e
e
e
v
v
C
C
v
e
e
"}
(3,1,1) = {"
e
e
e
e
v
C
C
C
C
v
v
e
e
C
C
C
C
C
v
e
"}
(4,1,1) = {"
e
e
e
v
C
C
C
C
C
C
v
v
v
C
C
C
C
C
v
e
"}
(5,1,1) = {"
e
e
v
C
C
C
C
C
C
C
v
v
C
C
C
C
C
C
v
e
"}
(6,1,1) = {"
e
v
C
C
C
C
C
C
C
C
v
v
C
C
C
C
C
C
C
v
"}
(7,1,1) = {"
e
v
C
C
C
C
C
C
C
C
v
v
C
C
C
C
C
C
C
v
"}
(8,1,1) = {"
e
v
C
C
C
C
C
C
C
C
v
v
v
C
C
C
C
C
C
v
"}
(9,1,1) = {"
e
v
C
C
C
C
C
C
C
C
v
v
v
C
C
C
C
C
C
v
"}
(10,1,1) = {"
e
v
C
C
C
C
C
C
C
C
Y
D
C
C
C
C
C
C
C
v
"}
(11,1,1) = {"
v
C
C
C
C
C
a
a
a
a
z
a
C
C
C
C
C
C
C
v
"}
(12,1,1) = {"
v
C
C
C
C
C
a
V
O
x
k
a
a
a
a
a
C
C
v
e
"}
(13,1,1) = {"
v
C
C
C
C
C
a
G
u
O
k
a
l
f
f
a
C
C
v
e
"}
(14,1,1) = {"
v
C
C
C
C
C
a
F
O
P
W
a
d
n
h
a
C
C
v
e
"}
(15,1,1) = {"
v
C
C
C
C
C
a
a
N
w
r
a
n
T
Q
a
C
C
v
e
"}
(16,1,1) = {"
v
C
C
C
C
C
C
a
U
E
p
g
y
J
B
a
C
C
v
e
"}
(17,1,1) = {"
e
e
v
C
C
C
C
a
a
a
q
a
m
o
A
a
C
v
v
e
"}
(18,1,1) = {"
e
e
e
v
C
C
C
C
C
a
a
a
a
a
a
a
C
v
e
e
"}
(19,1,1) = {"
e
e
e
e
v
v
v
v
C
C
C
C
C
C
C
C
C
v
e
e
"}
(20,1,1) = {"
e
e
e
e
e
e
e
e
v
v
v
v
v
v
v
v
v
e
e
e
"}
