//MAP CONVERTED BY dmm2tgm.py THIS HEADER COMMENT PREVENTS RECONVERSION, DO NOT REMOVE
"f" = (
/obj/effect/decal/cleanable/blood/gibs/body,
/turf/open/floor/plating/airless,
/area/ruin/unpowered)
"g" = (
/obj/structure/lattice,
/turf/closed/wall,
/area/ruin/unpowered)
"l" = (
/turf/open/floor/plating/asteroid/airless,
/area/ruin/unpowered)
"n" = (
/turf/template_noop,
/area/template_noop)
"r" = (
/turf/closed/wall,
/area/ruin/unpowered)
"t" = (
/obj/structure/lattice,
/turf/open/floor/plating/asteroid/airless,
/area/ruin/unpowered)
"z" = (
/obj/item/pickaxe/silver,
/turf/open/floor/plating/airless,
/area/ruin/unpowered)
"M" = (
/obj/structure/lattice,
/turf/template_noop,
/area/space/nearstation)
"P" = (
/turf/open/floor/plating/airless,
/area/ruin/unpowered)
"R" = (
/obj/item/lazarus_injector,
/obj/effect/decal/cleanable/blood/gibs/human/lizard/body,
/turf/open/floor/plating/airless,
/area/ruin/unpowered)
"Z" = (
/turf/closed/mineral/random/high_chance,
/area/ruin/unpowered)

(1,1,1) = {"
n
n
n
n
n
n
n
n
n
n
n
n
n
n
l
l
n
n
n
n
"}
(2,1,1) = {"
n
n
n
n
n
l
l
l
l
l
n
n
l
l
Z
Z
l
n
n
n
"}
(3,1,1) = {"
n
n
n
l
l
Z
Z
Z
Z
Z
l
n
l
Z
Z
Z
Z
l
n
n
"}
(4,1,1) = {"
n
n
l
Z
Z
Z
Z
Z
Z
t
n
n
l
Z
Z
Z
l
n
n
n
"}
(5,1,1) = {"
n
l
Z
Z
Z
Z
Z
Z
t
M
n
n
l
Z
Z
Z
Z
l
n
n
"}
(6,1,1) = {"
n
l
Z
Z
Z
Z
l
l
n
M
n
l
Z
Z
Z
Z
Z
Z
l
n
"}
(7,1,1) = {"
l
Z
Z
Z
Z
l
n
M
M
g
r
l
Z
Z
Z
Z
Z
Z
l
n
"}
(8,1,1) = {"
l
Z
Z
Z
Z
l
n
M
z
f
r
l
Z
Z
Z
Z
Z
Z
l
n
"}
(9,1,1) = {"
l
Z
Z
Z
t
M
M
M
R
P
M
t
t
Z
Z
Z
Z
Z
l
n
"}
(10,1,1) = {"
l
Z
Z
Z
l
n
n
r
r
M
n
n
n
Z
Z
Z
Z
Z
Z
n
"}
(11,1,1) = {"
n
l
Z
l
n
n
n
n
n
M
n
n
n
n
l
Z
Z
Z
Z
l
"}
(12,1,1) = {"
n
n
l
n
n
n
l
l
l
M
n
n
n
n
l
Z
Z
Z
Z
Z
"}
(13,1,1) = {"
n
n
n
n
n
l
Z
Z
Z
t
n
n
n
n
n
l
Z
Z
Z
Z
"}
(14,1,1) = {"
n
n
n
n
n
l
Z
Z
Z
Z
l
n
n
n
n
n
l
Z
Z
Z
"}
(15,1,1) = {"
n
n
n
n
l
Z
Z
Z
Z
Z
l
n
n
n
n
n
l
Z
Z
l
"}
(16,1,1) = {"
n
n
n
n
l
Z
Z
Z
Z
l
n
n
n
n
n
n
n
l
l
n
"}
(17,1,1) = {"
n
n
n
n
l
Z
Z
l
l
n
n
n
n
n
n
n
n
n
n
n
"}
(18,1,1) = {"
n
n
n
n
n
l
l
n
n
n
n
n
n
n
n
n
n
n
n
n
"}
