"e" = (/turf/template_noop,/area/template_noop)
"m" = (/turf/closed/mineral/random/no_caves,/area/ruin/space)
"q" = (/turf/open/floor/plating/asteroid/airless,/area/ruin/space)

(1,1,1) = {"
eeeeqqqeee
eeqqmmmqee
eqmmmmmmqe
qmmmmmmmmq
qmmmmmmmmq
eqmmmmmmqe
eeqmmmqqee
eeeqqqeeee
"}
