//MAP CONVERTED BY dmm2tgm.py THIS HEADER COMMENT PREVENTS RECONVERSION, DO NOT REMOVE
"a" = (
/obj/item/stack/sheet/metal,
/turf/template_noop,
/area/template_noop)
"b" = (
/obj/structure/lattice,
/obj/structure/lattice,
/obj/item/stack/sheet/metal,
/turf/template_noop,
/area/space/nearstation)
"c" = (
/turf/open/floor/plating/asteroid/airless,
/area/ruin/space)
"d" = (
/obj/item/chair,
/turf/open/floor/plating/airless{
	icon_state = "platingdmg1"
	},
/area/ruin/unpowered)
"e" = (
/obj/effect/decal/cleanable/blood/gibs/down,
/turf/open/floor/plating/airless{
	icon_state = "platingdmg1"
	},
/area/ruin/space)
"f" = (
/obj/structure/fluff/broken_flooring{
	dir = 4;
	icon_state = "singular"
	},
/turf/template_noop,
/area/template_noop)
"g" = (
/obj/structure/girder,
/turf/open/floor/plating/asteroid/airless,
/area/ruin/space)
"h" = (
/obj/item/chair/stool/bar,
/turf/open/floor/plating/airless{
	icon_state = "platingdmg3"
	},
/area/ruin/space)
"i" = (
/obj/structure/table/wood,
/turf/open/floor/plasteel/airless,
/area/ruin/space)
"j" = (
/obj/item/ammo_casing/shotgun/beanbag,
/turf/open/floor/plasteel/airless/cafeteria,
/area/ruin/space)
"k" = (
/turf/closed/wall,
/area/ruin/space)
"l" = (
/obj/structure/chair/stool/bar,
/turf/open/floor/plasteel/airless,
/area/ruin/space)
"m" = (
/obj/item/storage/box/drinkingglasses,
/obj/structure/table/wood,
/obj/machinery/light{
	dir = 8;
	icon_state = "tube-broken";
	status = 2
	},
/turf/open/floor/plasteel/airless/cafeteria,
/area/ruin/space)
"n" = (
/obj/item/stack/sheet/metal,
/turf/open/floor/plating/airless{
	icon_state = "platingdmg3"
	},
/area/ruin/unpowered)
"o" = (
/obj/structure/lattice,
/turf/template_noop,
/area/space/nearstation)
"p" = (
/obj/structure/fluff/broken_flooring{
	dir = 4;
	icon_state = "plating";
	name = "broken plating"
	},
/turf/template_noop,
/area/space/nearstation)
"q" = (
/obj/machinery/light{
	dir = 1;
	icon_state = "tube-broken";
	status = 2
	},
/turf/open/floor/plasteel/airless/cafeteria,
/area/ruin/space)
"r" = (
/obj/machinery/door/airlock/public/glass,
/turf/open/floor/plasteel/airless,
/area/ruin/space)
"s" = (
/obj/structure/table/wood,
/turf/open/floor/plasteel/airless/cafeteria,
/area/ruin/space)
"t" = (
/turf/open/floor/plasteel/airless/cafeteria,
/area/ruin/space)
"u" = (
/obj/structure/table/wood,
/obj/machinery/microwave,
/turf/open/floor/plasteel/airless/cafeteria,
/area/ruin/space)
"w" = (
/turf/open/floor/plating/airless{
	icon_state = "platingdmg1"
	},
/area/ruin/space)
"x" = (
/obj/structure/table/wood,
/obj/item/trash/plate,
/turf/open/floor/plasteel/airless,
/area/ruin/space)
"y" = (
/obj/structure/table_frame,
/turf/open/floor/plasteel/airless,
/area/ruin/space)
"z" = (
/obj/machinery/light{
	icon_state = "tube-broken";
	status = 2
	},
/turf/open/floor/plasteel/airless,
/area/ruin/space)
"A" = (
/obj/item/ammo_casing/c46x30mm,
/turf/open/floor/plating/airless{
	icon_state = "platingdmg1"
	},
/area/ruin/space)
"B" = (
/obj/structure/fluff/broken_flooring{
	icon_state = "singular"
	},
/turf/template_noop,
/area/template_noop)
"C" = (
/obj/structure/lattice,
/obj/structure/fluff/broken_flooring{
	dir = 1;
	icon_state = "side"
	},
/turf/template_noop,
/area/space/nearstation)
"D" = (
/obj/structure/table/wood,
/obj/item/storage/firstaid/brute,
/turf/open/floor/plasteel/airless/cafeteria,
/area/ruin/space)
"E" = (
/obj/structure/girder,
/turf/open/floor/plating/airless{
	icon_state = "platingdmg3"
	},
/area/ruin/space)
"F" = (
/obj/structure/closet/secure_closet/freezer/kitchen,
/turf/open/floor/plasteel/airless/cafeteria,
/area/ruin/space)
"G" = (
/turf/template_noop,
/area/template_noop)
"H" = (
/obj/machinery/vending/boozeomat,
/turf/open/floor/plasteel/airless/cafeteria,
/area/ruin/space)
"I" = (
/obj/structure/table/wood,
/obj/item/kitchen/fork,
/turf/open/floor/plasteel/airless,
/area/ruin/space)
"K" = (
/obj/item/ammo_casing/shotgun/improvised,
/turf/open/floor/plasteel/airless/cafeteria,
/area/ruin/space)
"L" = (
/obj/machinery/vending/dinnerware,
/turf/open/floor/plasteel/airless/cafeteria,
/area/ruin/space)
"M" = (
/turf/open/floor/plating/airless{
	icon_state = "platingdmg1"
	},
/area/ruin/unpowered)
"N" = (
/turf/open/floor/plating/airless{
	icon_state = "platingdmg3"
	},
/area/ruin/space)
"O" = (
/obj/item/stack/sheet/metal,
/turf/open/floor/plating/airless{
	icon_state = "platingdmg3"
	},
/area/ruin/space)
"P" = (
/obj/item/toy/plush/beeplushie,
/obj/vehicle/ridden/lavaboat,
/turf/open/floor/plasteel/airless,
/area/ruin/space)
"Q" = (
/obj/effect/decal/remains/human,
/obj/effect/decal/cleanable/blood/splatter,
/turf/open/floor/plasteel/airless,
/area/ruin/space)
"R" = (
/obj/structure/fluff/broken_flooring{
	dir = 1;
	icon_state = "plating";
	name = "broken plating"
	},
/turf/open/floor/plating/asteroid/airless,
/area/ruin/space)
"S" = (
/obj/item/ammo_casing/c46x30mm,
/turf/open/floor/plating/airless{
	icon_state = "platingdmg3"
	},
/area/ruin/space)
"T" = (
/obj/structure/closet/secure_closet/freezer/fridge,
/turf/open/floor/plasteel/airless/cafeteria,
/area/ruin/space)
"U" = (
/obj/item/chair/stool/bar,
/turf/open/floor/plasteel/airless,
/area/ruin/space)
"V" = (
/obj/structure/lattice,
/obj/item/stack/sheet/metal,
/turf/template_noop,
/area/space/nearstation)
"W" = (
/obj/structure/lattice,
/obj/structure/fluff/broken_flooring{
	dir = 1;
	icon_state = "plating";
	name = "broken plating"
	},
/turf/template_noop,
/area/space/nearstation)
"X" = (
/turf/open/floor/plasteel/airless,
/area/ruin/space)
"Y" = (
/obj/effect/decal/remains/human,
/obj/effect/decal/cleanable/blood/old,
/obj/item/clothing/head/chefhat,
/turf/open/floor/plasteel/airless/cafeteria,
/area/ruin/space)
"Z" = (
/turf/closed/mineral/random,
/area/ruin/space)

(1,1,1) = {"
G
G
G
G
G
G
G
G
G
G
c
c
c
c
c
c
G
G
G
G
"}
(2,1,1) = {"
G
G
G
G
c
c
c
G
G
c
Z
Z
Z
Z
Z
Z
c
G
G
G
"}
(3,1,1) = {"
G
G
G
c
Z
Z
Z
c
c
Z
Z
Z
Z
Z
Z
Z
Z
c
G
G
"}
(4,1,1) = {"
G
G
c
Z
Z
Z
Z
Z
Z
Z
Z
Z
Z
Z
Z
Z
Z
Z
c
G
"}
(5,1,1) = {"
G
G
c
Z
Z
Z
Z
Z
Z
Z
Z
Z
Z
Z
Z
Z
Z
Z
c
G
"}
(6,1,1) = {"
G
G
G
c
Z
c
R
E
k
k
k
k
k
k
k
Z
Z
Z
Z
c
"}
(7,1,1) = {"
G
G
f
G
c
o
n
X
X
z
k
H
m
L
k
Z
Z
Z
Z
c
"}
(8,1,1) = {"
G
G
G
G
G
V
C
N
N
l
I
t
j
s
k
Z
Z
Z
Z
c
"}
(9,1,1) = {"
G
G
c
c
G
o
W
A
S
h
x
j
Y
D
k
Z
Z
Z
Z
c
"}
(10,1,1) = {"
G
c
Z
Z
c
o
d
e
Q
U
y
K
t
s
k
Z
Z
Z
c
G
"}
(11,1,1) = {"
c
Z
Z
Z
c
o
M
A
S
l
i
t
j
u
k
X
Z
Z
Z
c
"}
(12,1,1) = {"
c
Z
Z
c
G
G
p
w
N
N
k
q
t
s
E
X
P
Z
Z
c
"}
(13,1,1) = {"
G
c
c
G
G
o
b
X
O
N
r
t
t
t
E
X
X
Z
Z
c
"}
(14,1,1) = {"
G
G
G
B
G
a
o
X
X
z
k
T
T
F
E
X
X
Z
Z
c
"}
(15,1,1) = {"
G
G
G
G
G
c
g
E
k
k
k
k
k
k
k
X
Z
Z
c
G
"}
(16,1,1) = {"
G
G
G
G
c
Z
Z
Z
Z
Z
Z
Z
Z
Z
Z
Z
Z
Z
c
G
"}
(17,1,1) = {"
G
G
G
c
Z
Z
Z
Z
Z
Z
c
Z
Z
Z
Z
Z
c
c
G
G
"}
(18,1,1) = {"
G
G
G
c
Z
Z
Z
Z
Z
c
G
c
c
c
c
c
G
G
G
G
"}
(19,1,1) = {"
G
G
G
G
c
Z
Z
Z
Z
c
G
G
G
G
G
G
G
G
G
G
"}
(20,1,1) = {"
G
G
G
G
G
c
c
c
c
G
G
G
G
G
G
G
G
G
G
G
"}
