//MAP CONVERTED BY dmm2tgm.py THIS HEADER COMMENT PREVENTS RECONVERSION, DO NOT REMOVE
"bG" = (
/obj/machinery/light{
	dir = 4
	},
/obj/structure/cable{
	icon_state = "1-2"
	},
/turf/open/floor/festive/wooden/wooden1,
/area/survivalpod/nonpowered)
"cc" = (
/obj/machinery/vending/games{
	pixel_y = 29;
	density = 0
	},
/turf/open/floor/festive/wooden/wooden1,
/area/survivalpod/nonpowered)
"dH" = (
/obj/machinery/chem_dispenser/drinks/beer{
	pixel_y = 30;
	density = 0
	},
/turf/open/floor/festive/wooden/wooden1,
/area/survivalpod/nonpowered)
"fp" = (
/obj/structure/chair/office/dark{
	dir = 4
	},
/turf/open/floor/carpet/royalblue,
/area/survivalpod/nonpowered)
"fC" = (
/obj/structure/bookcase/random{
	pixel_y = 32;
	density = 0
	},
/turf/open/floor/festive/wooden/wooden1,
/area/survivalpod/nonpowered)
"fM" = (
/obj/machinery/recharge_station/fullupgrade,
/turf/open/floor/pod/dark,
/area/survivalpod/nonpowered)
"fN" = (
/obj/machinery/door/airlock/survival_pod/glass,
/turf/open/floor/noslip,
/area/survivalpod/nonpowered)
"gr" = (
/obj/structure/cable{
	icon_state = "4-8"
	},
/obj/machinery/power/rtg/advanced/fullupgrade,
/obj/structure/cable{
	icon_state = "0-8"
	},
/turf/open/floor/pod/dark,
/area/survivalpod/nonpowered)
"gC" = (
/obj/structure/cable{
	icon_state = "1-2"
	},
/turf/open/floor/festive/wooden/wooden1,
/area/survivalpod/nonpowered)
"gG" = (
/obj/structure/chair/comfy/black{
	dir = 8
	},
/turf/open/floor/festive/wooden/wooden1,
/area/survivalpod/nonpowered)
"hr" = (
/obj/machinery/door/airlock/survival_pod/glass,
/obj/machinery/poweredfans,
/obj/structure/cable{
	icon_state = "4-8"
	},
/turf/open/floor/pod/dark,
/area/survivalpod/nonpowered)
"iu" = (
/obj/structure/curtain,
/obj/machinery/door/window/survival_pod{
	dir = 4
	},
/obj/structure/window/reinforced/tinted{
	dir = 1
	},
/turf/open/floor/noslip,
/area/survivalpod/nonpowered)
"iD" = (
/obj/item/gps/computer,
/turf/open/floor/pod/dark,
/area/survivalpod/nonpowered)
"iY" = (
/obj/structure/bed/double/pod{
	dir = 4
	},
/obj/item/bedsheet/cosmos/double{
	dir = 1
	},
/obj/item/toy/plush/mothplushie,
/turf/open/floor/festive/wooden/wooden1,
/area/survivalpod/nonpowered)
"jA" = (
/obj/structure/cable{
	icon_state = "1-4"
	},
/obj/structure/cable{
	icon_state = "1-2"
	},
/turf/open/floor/festive/wooden/wooden1,
/area/survivalpod/nonpowered)
"ko" = (
/obj/machinery/vending/boozeomat{
	density = 0;
	pixel_y = 32
	},
/turf/open/floor/festive/wooden/wooden1,
/area/survivalpod/nonpowered)
"lO" = (
/obj/machinery/poweredfans,
/obj/machinery/door/airlock/survival_pod/glass,
/obj/structure/cable{
	icon_state = "1-2"
	},
/turf/open/floor/pod/dark,
/area/survivalpod/nonpowered)
"lW" = (
/obj/structure/chair/sofa/corp{
	dir = 1
	},
/turf/open/floor/festive/wooden/wooden1,
/area/survivalpod/nonpowered)
"mC" = (
/obj/structure/chair/sofa/corp/right{
	dir = 8
	},
/turf/open/floor/festive/wooden/wooden1,
/area/survivalpod/nonpowered)
"mN" = (
/obj/machinery/power/rtg/advanced/fullupgrade,
/obj/structure/cable{
	icon_state = "0-8"
	},
/turf/open/floor/pod/dark,
/area/survivalpod/nonpowered)
"oo" = (
/obj/structure/table/plasmaglass{
	density = 1
	},
/turf/open/floor/festive/wooden/wooden1,
/area/survivalpod/nonpowered)
"pg" = (
/obj/structure/chair/comfy/black,
/turf/open/floor/carpet/royalblue,
/area/survivalpod/nonpowered)
"pF" = (
/obj/structure/closet/cabinet,
/obj/item/clothing/under/misc/bathrobe,
/turf/open/floor/festive/wooden/wooden1,
/area/survivalpod/nonpowered)
"qE" = (
/obj/structure/sink{
	pixel_y = 24
	},
/obj/structure/mirror{
	pixel_y = 34
	},
/turf/open/floor/mineral/silver,
/area/survivalpod/nonpowered)
"rM" = (
/obj/structure/chair/sofa/corp/corner{
	dir = 8
	},
/turf/open/floor/festive/wooden/wooden1,
/area/survivalpod/nonpowered)
"rZ" = (
/obj/machinery/washing_machine,
/turf/open/floor/mineral/silver,
/area/survivalpod/nonpowered)
"sD" = (
/obj/machinery/camera{
	dir = 5
	},
/turf/open/floor/festive/wooden/wooden1,
/area/survivalpod/nonpowered)
"td" = (
/obj/machinery/light{
	dir = 4
	},
/obj/structure/easel,
/obj/item/canvas/twentythreeXtwentythree,
/obj/item/storage/crayons,
/turf/open/floor/festive/wooden/wooden1,
/area/survivalpod/nonpowered)
"um" = (
/obj/structure/table/wood/fancy/royalblack,
/obj/item/reagent_containers/food/drinks/bottle/lizardwine,
/turf/open/floor/carpet/royalblue,
/area/survivalpod/nonpowered)
"uR" = (
/obj/machinery/light,
/turf/open/floor/festive/wooden/wooden1,
/area/survivalpod/nonpowered)
"vU" = (
/obj/machinery/sleeper/survival_pod,
/obj/machinery/vending/wallmed{
	pixel_x = -26
	},
/turf/open/floor/pod/dark,
/area/survivalpod/nonpowered)
"wv" = (
/obj/machinery/holopad,
/turf/open/floor/carpet/royalblue,
/area/survivalpod/nonpowered)
"wI" = (
/obj/machinery/light{
	dir = 4
	},
/turf/open/floor/festive/wooden/wooden1,
/area/survivalpod/nonpowered)
"xC" = (
/obj/machinery/light{
	dir = 4
	},
/obj/structure/table/plasmaglass,
/obj/structure/bedsheetbin/towel,
/turf/open/floor/mineral/silver,
/area/survivalpod/nonpowered)
"zo" = (
/obj/structure/dresser,
/turf/open/floor/carpet/royalblue,
/area/survivalpod/nonpowered)
"zp" = (
/obj/structure/cable{
	icon_state = "4-8"
	},
/turf/open/floor/pod/dark,
/area/survivalpod/nonpowered)
"zW" = (
/obj/structure/sign/painting/library,
/turf/closed/wall/mineral/titanium/survival/pod,
/area/survivalpod/nonpowered)
"BI" = (
/obj/machinery/chem_dispenser/drinks{
	pixel_y = 30
	},
/turf/open/floor/festive/wooden/wooden1,
/area/survivalpod/nonpowered)
"Cj" = (
/turf/open/floor/festive/wooden/wooden1,
/area/survivalpod/nonpowered)
"Cq" = (
/obj/machinery/poweredfans,
/obj/structure/window/shuttle/survival_pod,
/turf/open/floor/pod/dark,
/area/survivalpod/nonpowered)
"Ec" = (
/obj/structure/closet/cabinet,
/obj/item/clothing/under/misc/bathrobe,
/obj/machinery/airalarm/directional/north,
/turf/open/floor/festive/wooden/wooden1,
/area/survivalpod/nonpowered)
"EV" = (
/obj/structure/table/plasmaglass,
/obj/item/modular_computer/laptop/preset/civilian,
/turf/open/floor/festive/wooden/wooden1,
/area/survivalpod/nonpowered)
"Fo" = (
/obj/machinery/smartfridge/survival_pod,
/turf/open/floor/pod/dark,
/area/survivalpod/nonpowered)
"Fw" = (
/obj/structure/chair/sofa/corp/left{
	dir = 4
	},
/turf/open/floor/festive/wooden/wooden1,
/area/survivalpod/nonpowered)
"FE" = (
/obj/machinery/light,
/turf/open/floor/noslip,
/area/survivalpod/nonpowered)
"FT" = (
/obj/machinery/airalarm/directional/east,
/obj/structure/cable{
	icon_state = "1-2"
	},
/turf/open/floor/festive/wooden/wooden1,
/area/survivalpod/nonpowered)
"FZ" = (
/turf/closed/wall/mineral/titanium/survival/pod,
/area/survivalpod/nonpowered)
"Gd" = (
/obj/structure/cable{
	icon_state = "1-2"
	},
/obj/structure/cable{
	icon_state = "1-4"
	},
/turf/open/floor/festive/wooden/wooden1,
/area/survivalpod/nonpowered)
"JE" = (
/obj/structure/table/wood/fancy/royalblack,
/obj/item/reagent_containers/food/drinks/drinkingglass,
/obj/item/reagent_containers/food/drinks/drinkingglass,
/turf/open/floor/carpet/royalblue,
/area/survivalpod/nonpowered)
"JL" = (
/turf/open/floor/mineral/silver,
/area/survivalpod/nonpowered)
"Lv" = (
/turf/open/floor/pod/dark,
/area/survivalpod/nonpowered)
"Ng" = (
/obj/machinery/modular_computer/console/preset/civilian{
	dir = 8
	},
/turf/open/floor/festive/wooden/wooden1,
/area/survivalpod/nonpowered)
"Qr" = (
/obj/structure/window/shuttle/survival_pod,
/obj/machinery/poweredfans,
/turf/open/floor/pod/dark,
/area/survivalpod/nonpowered)
"QT" = (
/obj/structure/rack,
/obj/item/clothing/shoes/sandal,
/obj/machinery/light,
/turf/open/floor/festive/wooden/wooden1,
/area/survivalpod/nonpowered)
"Ro" = (
/obj/structure/chair/comfy/black{
	dir = 4
	},
/turf/open/floor/festive/wooden/wooden1,
/area/survivalpod/nonpowered)
"Ry" = (
/obj/structure/fireplace,
/obj/item/stack/sheet/mineral/wood/fifty,
/turf/open/floor/festive/wooden/wooden1,
/area/survivalpod/nonpowered)
"RD" = (
/obj/structure/cable{
	icon_state = "4-8"
	},
/turf/open/floor/festive/wooden/wooden1,
/area/survivalpod/nonpowered)
"RH" = (
/obj/machinery/shower{
	pixel_y = 18
	},
/obj/structure/window/reinforced/tinted{
	dir = 4
	},
/turf/open/floor/noslip,
/area/survivalpod/nonpowered)
"Tc" = (
/obj/structure/toilet{
	dir = 4
	},
/turf/open/floor/mineral/silver,
/area/survivalpod/nonpowered)
"TQ" = (
/obj/structure/fans,
/turf/open/floor/pod/dark,
/area/survivalpod/nonpowered)
"Ub" = (
/obj/structure/chair/sofa/corp/corner{
	dir = 1
	},
/turf/open/floor/festive/wooden/wooden1,
/area/survivalpod/nonpowered)
"Vp" = (
/turf/open/floor/carpet/royalblue,
/area/survivalpod/nonpowered)
"Vv" = (
/obj/structure/table/plasmaglass,
/obj/machinery/newscaster{
	pixel_x = 26
	},
/obj/item/paper_bin,
/obj/item/pen/fountain,
/turf/open/floor/festive/wooden/wooden1,
/area/survivalpod/nonpowered)
"VJ" = (
/obj/structure/cable{
	icon_state = "4-8"
	},
/turf/open/floor/carpet/royalblue,
/area/survivalpod/nonpowered)
"Wk" = (
/obj/machinery/light{
	dir = 1
	},
/turf/open/floor/festive/wooden/wooden1,
/area/survivalpod/nonpowered)
"Ws" = (
/obj/machinery/light{
	dir = 8
	},
/turf/open/floor/festive/wooden/wooden1,
/area/survivalpod/nonpowered)
"Xh" = (
/obj/machinery/door/airlock/survival_pod/glass,
/turf/open/floor/pod/dark,
/area/survivalpod/nonpowered)
"Xr" = (
/obj/machinery/door/airlock/survival_pod,
/obj/structure/cable{
	icon_state = "4-8"
	},
/turf/open/floor/pod/dark,
/area/survivalpod/nonpowered)
"Xy" = (
/obj/machinery/light,
/obj/machinery/power/apc/auto_name/south,
/obj/structure/cable{
	icon_state = "0-4"
	},
/obj/structure/cable{
	icon_state = "4-8"
	},
/turf/open/floor/pod/dark,
/area/survivalpod/nonpowered)
"YC" = (
/obj/machinery/light{
	dir = 1
	},
/obj/machinery/telecomms/relay/preset/station,
/obj/item/multitool,
/turf/open/floor/festive/wooden/wooden1,
/area/survivalpod/nonpowered)
"YH" = (
/obj/machinery/mineral/equipment_vendor,
/turf/open/floor/pod/dark,
/area/survivalpod/nonpowered)

(1,1,1) = {"
FZ
FZ
FZ
FZ
FZ
FZ
FZ
FZ
Qr
Qr
Qr
Qr
FZ
"}
(2,1,1) = {"
FZ
RH
FE
FZ
iY
FZ
iY
FZ
BI
Cj
Fw
Ub
Cq
"}
(3,1,1) = {"
FZ
Tc
iu
zW
Wk
zo
uR
FZ
dH
pg
JE
lW
Qr
"}
(4,1,1) = {"
FZ
qE
JL
fN
Cj
Vp
Cj
FZ
Ry
pg
um
lW
Qr
"}
(5,1,1) = {"
FZ
rZ
xC
FZ
Ec
Cj
pF
FZ
ko
Cj
mC
rM
Qr
"}
(6,1,1) = {"
FZ
FZ
FZ
FZ
FZ
Xh
FZ
FZ
cc
Cj
Cj
QT
FZ
"}
(7,1,1) = {"
lO
gC
gC
gC
bG
gC
Gd
gC
gC
FT
gC
jA
lO
"}
(8,1,1) = {"
FZ
FZ
FZ
FZ
FZ
YC
RD
Cj
FZ
FZ
FZ
Xr
FZ
"}
(9,1,1) = {"
FZ
fC
sD
Cj
Ws
Cj
RD
Ro
FZ
TQ
vU
zp
FZ
"}
(10,1,1) = {"
FZ
fC
Vp
Vp
wv
Vp
VJ
EV
FZ
YH
fM
Xy
FZ
"}
(11,1,1) = {"
FZ
fC
Vp
Vp
fp
Vp
VJ
gG
FZ
Fo
Lv
gr
FZ
"}
(12,1,1) = {"
FZ
fC
wI
Ng
Vv
oo
RD
td
FZ
iD
Lv
mN
FZ
"}
(13,1,1) = {"
FZ
Qr
FZ
Qr
FZ
Qr
hr
FZ
FZ
FZ
FZ
FZ
FZ
"}
