//MAP CONVERTED BY dmm2tgm.py THIS HEADER COMMENT PREVENTS RECONVERSION, DO NOT REMOVE
"aa" = (
/turf/template_noop,
/area/template_noop)
"ab" = (
/obj/structure/table/wood/fancy/black,
/obj/item/documents/syndicate/mining,
/obj/effect/decal/cleanable/cobweb,
/turf/open/floor/plasteel/cult,
/area/ruin/lavaland/unpowered/buried_library)
"ac" = (
/turf/closed/wall/mineral/wood,
/area/ruin/lavaland/unpowered/buried_library)
"ad" = (
/turf/closed/mineral/random/snow,
/area/icemoon/underground/explored)
"ae" = (
/turf/open/floor/wood,
/area/ruin/lavaland/unpowered/buried_library)
"af" = (
/obj/item/stack/sheet/mineral/wood,
/turf/open/floor/wood,
/area/ruin/lavaland/unpowered/buried_library)
"ag" = (
/obj/item/feather,
/turf/open/floor/wood,
/area/ruin/lavaland/unpowered/buried_library)
"ah" = (
/obj/structure/bookcase/random,
/turf/open/floor/wood,
/area/ruin/lavaland/unpowered/buried_library)
"ai" = (
/obj/structure/table/wood/fancy/black,
/obj/item/paper/crumpled/fluff/stations/lavaland/library/diary2,
/obj/effect/decal/cleanable/cobweb/cobweb2,
/turf/open/floor/plasteel/cult,
/area/ruin/lavaland/unpowered/buried_library)
"ak" = (
/turf/closed/mineral/random/snow,
/area/ruin/lavaland/unpowered/buried_library)
"al" = (
/turf/closed/wall/mineral/iron,
/area/ruin/lavaland/unpowered/buried_library)
"am" = (
/obj/structure/table/wood/fancy/black,
/obj/item/book_of_babel,
/turf/open/floor/plasteel/cult,
/area/ruin/lavaland/unpowered/buried_library)
"ao" = (
/obj/effect/decal/cleanable/dirt,
/turf/open/floor/wood,
/area/ruin/lavaland/unpowered/buried_library)
"ap" = (
/obj/item/stack/sheet/mineral/wood,
/obj/effect/decal/cleanable/dirt,
/turf/open/floor/wood,
/area/ruin/lavaland/unpowered/buried_library)
"aq" = (
/obj/structure/fluff/paper{
	dir = 1
	},
/turf/open/floor/wood,
/area/ruin/lavaland/unpowered/buried_library)
"ar" = (
/turf/open/floor/plasteel/cult,
/area/ruin/lavaland/unpowered/buried_library)
"as" = (
/obj/effect/decal/cleanable/dirt,
/obj/item/paper/fluff/ruins/oldstation/protosing,
/turf/closed/mineral/random/snow,
/area/ruin/lavaland/unpowered/buried_library)
"at" = (
/obj/structure/fluff/paper,
/turf/open/floor/wood,
/area/ruin/lavaland/unpowered/buried_library)
"av" = (
/obj/structure/bookcase/random,
/turf/closed/mineral/random/snow,
/area/ruin/lavaland/unpowered/buried_library)
"aw" = (
/turf/open/floor/plating,
/area/ruin/lavaland/unpowered/buried_library)
"ax" = (
/obj/effect/decal/cleanable/dirt,
/turf/closed/mineral/random/snow,
/area/ruin/lavaland/unpowered/buried_library)
"ay" = (
/obj/machinery/door/keycard/library,
/turf/open/floor/plasteel/cult,
/area/ruin/lavaland/unpowered/buried_library)
"az" = (
/obj/item/paper/crumpled/fluff/stations/lavaland/library/diary,
/turf/open/floor/wood,
/area/ruin/lavaland/unpowered/buried_library)
"aA" = (
/obj/effect/decal/cleanable/dirt,
/turf/open/floor/plating,
/area/ruin/lavaland/unpowered/buried_library)
"aC" = (
/obj/item/feather,
/turf/closed/mineral/random/snow,
/area/ruin/lavaland/unpowered/buried_library)
"aD" = (
/turf/open/floor/carpet/black,
/area/ruin/lavaland/unpowered/buried_library)
"aE" = (
/obj/item/stack/sheet/mineral/wood,
/obj/item/book/manual/random,
/turf/open/floor/wood,
/area/ruin/lavaland/unpowered/buried_library)
"aF" = (
/obj/item/book/manual/random,
/obj/effect/decal/cleanable/dirt,
/turf/closed/mineral/random/snow,
/area/ruin/lavaland/unpowered/buried_library)
"aG" = (
/obj/structure/table/bronze,
/obj/item/stack/ore/slag,
/turf/open/floor/carpet/black,
/area/ruin/lavaland/unpowered/buried_library)
"aH" = (
/obj/structure/table/bronze,
/obj/item/statuebust,
/turf/open/floor/carpet/black,
/area/ruin/lavaland/unpowered/buried_library)
"aI" = (
/obj/effect/mob_spawn/human/skeleton,
/obj/item/clothing/head/rice_hat,
/turf/open/floor/plasteel/cult,
/area/ruin/lavaland/unpowered/buried_library)
"aJ" = (
/obj/effect/decal/cleanable/dirt,
/turf/open/floor/plasteel/cult,
/area/ruin/lavaland/unpowered/buried_library)
"aK" = (
/obj/item/feather,
/obj/effect/decal/cleanable/dirt,
/turf/open/floor/plasteel/cult,
/area/ruin/lavaland/unpowered/buried_library)
"aL" = (
/obj/effect/decal/cleanable/dirt,
/obj/structure/fluff/paper/stack,
/turf/open/floor/wood,
/area/ruin/lavaland/unpowered/buried_library)
"aM" = (
/obj/item/stack/sheet/mineral/wood,
/obj/item/book/manual/random,
/turf/closed/mineral/random/snow,
/area/ruin/lavaland/unpowered/buried_library)
"aN" = (
/obj/structure/statue/sandstone/venus,
/turf/open/floor/carpet/black,
/area/ruin/lavaland/unpowered/buried_library)
"aO" = (
/mob/living/simple_animal/pet/fox,
/turf/open/floor/wood,
/area/ruin/lavaland/unpowered/buried_library)
"aP" = (
/obj/item/keycard/library,
/turf/closed/mineral/random/snow,
/area/ruin/lavaland/unpowered/buried_library)
"aQ" = (
/obj/effect/decal/cleanable/dirt,
/obj/item/paper/fluff/awaymissions/moonoutpost19/research/larva_autopsy,
/turf/open/floor/wood,
/area/ruin/lavaland/unpowered/buried_library)
"aR" = (
/obj/structure/fluff/paper/stack,
/turf/open/floor/wood,
/area/ruin/lavaland/unpowered/buried_library)
"aS" = (
/obj/structure/table/wood/fancy/black,
/obj/effect/decal/cleanable/dirt,
/obj/item/paper/secretrecipe,
/obj/item/flashlight/lantern/jade{
	on = 1
	},
/turf/open/floor/plasteel/cult,
/area/ruin/lavaland/unpowered/buried_library)
"aT" = (
/obj/effect/decal/cleanable/dirt,
/obj/structure/fluff/paper,
/turf/open/floor/wood,
/area/ruin/lavaland/unpowered/buried_library)
"aV" = (
/obj/item/stack/sheet/mineral/wood,
/obj/structure/fluff/paper/stack,
/turf/open/floor/wood,
/area/ruin/lavaland/unpowered/buried_library)
"aW" = (
/obj/structure/fluff/paper/stack,
/turf/open/floor/plasteel/cult,
/area/ruin/lavaland/unpowered/buried_library)
"aX" = (
/obj/structure/table/bronze,
/obj/item/statuebust,
/turf/open/floor/plating,
/area/ruin/lavaland/unpowered/buried_library)
"aY" = (
/obj/structure/table_frame/wood,
/turf/open/floor/plating,
/area/ruin/lavaland/unpowered/buried_library)
"aZ" = (
/obj/structure/fluff/paper/stack,
/obj/structure/fluff/paper,
/turf/open/floor/wood,
/area/ruin/lavaland/unpowered/buried_library)
"ba" = (
/obj/structure/barricade/wooden/snowed,
/turf/closed/mineral/random/snow,
/area/ruin/lavaland/unpowered/buried_library)
"bc" = (
/obj/item/feather,
/obj/structure/fluff/paper,
/obj/structure/fluff/paper{
	dir = 1
	},
/turf/open/floor/wood,
/area/ruin/lavaland/unpowered/buried_library)
"bd" = (
/obj/effect/decal/cleanable/dirt,
/obj/structure/fluff/paper{
	dir = 1
	},
/turf/open/floor/wood,
/area/ruin/lavaland/unpowered/buried_library)
"be" = (
/obj/structure/fluff/paper{
	dir = 5
	},
/turf/open/floor/wood,
/area/ruin/lavaland/unpowered/buried_library)
"bf" = (
/obj/effect/decal/cleanable/dirt,
/obj/structure/fluff/paper{
	dir = 4
	},
/turf/open/floor/wood,
/area/ruin/lavaland/unpowered/buried_library)
"bg" = (
/obj/item/paper/fluff/ruins/oldstation/protogun,
/turf/closed/mineral/random/snow,
/area/ruin/lavaland/unpowered/buried_library)
"bh" = (
/obj/effect/decal/cleanable/dirt,
/mob/living/simple_animal/pet/fox,
/turf/open/floor/wood,
/area/ruin/lavaland/unpowered/buried_library)
"bi" = (
/obj/structure/fluff/paper,
/turf/closed/mineral/random/snow,
/area/ruin/lavaland/unpowered/buried_library)
"bj" = (
/obj/item/book/manual/random,
/turf/closed/mineral/random/snow,
/area/ruin/lavaland/unpowered/buried_library)
"bk" = (
/obj/structure/fluff/paper{
	dir = 10
	},
/turf/open/floor/wood,
/area/ruin/lavaland/unpowered/buried_library)
"bl" = (
/obj/item/storage/box/fountainpens,
/turf/closed/mineral/random/snow,
/area/ruin/lavaland/unpowered/buried_library)
"bm" = (
/obj/structure/fluff/paper/stack,
/turf/closed/mineral/random/snow,
/area/ruin/lavaland/unpowered/buried_library)
"bn" = (
/obj/item/book/manual/random,
/obj/item/stack/sheet/mineral/wood,
/turf/closed/mineral/random/snow,
/area/ruin/lavaland/unpowered/buried_library)
"bo" = (
/obj/item/stack/sheet/mineral/wood,
/turf/closed/mineral/random/snow,
/area/ruin/lavaland/unpowered/buried_library)
"bp" = (
/obj/effect/decal/cleanable/dirt,
/obj/structure/fluff/paper,
/turf/closed/mineral/random/snow,
/area/ruin/lavaland/unpowered/buried_library)
"bq" = (
/obj/structure/mineral_door/wood,
/obj/structure/barricade/wooden/crude/snow,
/turf/open/floor/wood,
/area/ruin/lavaland/unpowered/buried_library)
"br" = (
/obj/structure/girder,
/turf/closed/mineral/random/snow,
/area/ruin/lavaland/unpowered/buried_library)
"bt" = (
/obj/effect/decal/cleanable/dirt,
/turf/template_noop,
/area/template_noop)
"bu" = (
/obj/item/stack/sheet/mineral/wood,
/turf/closed/mineral/random/snow,
/area/icemoon/underground/explored)
"bw" = (
/turf/open/floor/wood,
/area/icemoon/underground/explored)
"by" = (
/obj/item/statuebust,
/turf/open/floor/carpet/black,
/area/ruin/lavaland/unpowered/buried_library)
"bz" = (
/obj/item/flashlight/lantern/jade{
	on = 1
	},
/turf/open/floor/plating,
/area/ruin/lavaland/unpowered/buried_library)
"bA" = (
/obj/structure/fluff/paper/stack,
/turf/open/floor/plating,
/area/ruin/lavaland/unpowered/buried_library)
"bB" = (
/obj/structure/fluff/paper/stack,
/turf/open/floor/carpet/black,
/area/ruin/lavaland/unpowered/buried_library)
"bC" = (
/obj/effect/decal/cleanable/dirt,
/obj/structure/fluff/paper{
	dir = 1
	},
/mob/living/simple_animal/pet/fox,
/turf/open/floor/wood,
/area/ruin/lavaland/unpowered/buried_library)

(1,1,1) = {"
aa
aa
aa
aa
aa
aa
aa
aa
aa
aa
aa
aa
aa
aa
ad
ad
ad
ad
ad
ad
ad
bt
aa
"}
(2,1,1) = {"
aa
aa
aa
aa
aa
aa
aa
aa
aa
aa
ak
ak
ak
ak
ak
ac
ba
ac
ac
ac
ad
ad
aa
"}
(3,1,1) = {"
aa
aa
aa
aa
aa
aa
aa
ak
ak
ak
ak
bo
ak
ak
ak
bm
ae
af
bk
ac
ad
ad
aa
"}
(4,1,1) = {"
aa
aa
aa
aa
aa
aa
ak
ak
aR
ak
ak
ae
bj
av
ak
ah
aL
ah
aT
ac
ad
aa
aa
"}
(5,1,1) = {"
aa
aa
aa
aa
aa
ak
ak
ak
aC
ae
aQ
ah
ak
av
bg
ah
aT
ah
ak
ac
ad
ad
aa
"}
(6,1,1) = {"
aa
aa
aa
aa
ad
ac
ak
ae
ak
aM
aO
ah
bm
ah
aA
ah
ao
ah
aq
ac
ad
ad
ad
"}
(7,1,1) = {"
aa
aa
aa
aa
ad
ac
ak
bm
ak
ao
aR
ao
aA
ao
ae
ah
aZ
ah
bC
ac
ad
ad
ad
"}
(8,1,1) = {"
aa
aa
aa
aa
ad
ak
ak
av
aA
ak
aG
aD
aX
ak
ao
ae
ao
ah
ae
ac
br
ad
ad
"}
(9,1,1) = {"
aa
aa
aa
aa
ad
ac
as
av
aF
aD
aD
bz
aD
bB
ak
ae
ao
ae
ao
ac
ax
bw
ad
"}
(10,1,1) = {"
aa
aa
aa
ad
ad
ac
ap
ax
ak
aD
aD
aN
ak
aw
ak
ao
af
aR
ae
bq
ae
bu
ad
"}
(11,1,1) = {"
aa
al
al
al
al
al
ae
ah
aR
aD
ak
aD
aD
by
ao
aw
ao
ae
bm
ac
ae
ad
ad
"}
(12,1,1) = {"
ad
al
ab
aI
ar
al
aR
aE
af
aD
aH
bA
aY
aD
ak
ae
bm
ah
ag
br
ac
ad
ad
"}
(13,1,1) = {"
ad
al
am
aJ
aW
ay
ae
ah
ao
ae
ao
ae
af
ax
bi
ah
ak
ah
bp
ac
ad
ad
ad
"}
(14,1,1) = {"
ad
al
aS
aW
aK
al
at
ah
ak
ah
bh
ah
az
ah
ak
ah
ak
bn
aT
ac
ad
aa
aa
"}
(15,1,1) = {"
ad
al
al
ai
ar
al
bc
ah
aL
ah
aA
ah
ao
ah
ak
ak
bl
ak
ak
ak
ad
aa
aa
"}
(16,1,1) = {"
ad
ad
al
al
al
al
bd
ah
ao
ah
ao
aV
ak
ah
ax
ak
bm
bo
ak
br
bu
aa
aa
"}
(17,1,1) = {"
aa
ad
ad
ad
ad
ac
be
bf
ae
aP
ae
aR
ae
ax
ak
bj
ak
ad
ad
ad
aa
aa
aa
"}
(18,1,1) = {"
aa
aa
aa
aa
ad
ac
ac
ac
ac
ac
ac
ba
ac
ac
br
ad
aa
ad
aa
aa
aa
aa
aa
"}
(19,1,1) = {"
aa
aa
aa
aa
aa
ad
ad
ad
ad
ad
ad
aa
ad
ad
aa
aa
aa
aa
aa
aa
aa
aa
aa
"}
